a a a a a a a a a a a a a a a a a a a a a a a a a a a a a a a a a a a a a a a a a a a a a a a a a a a a a a a a a a a a a a a a a a a a a a a a a a a a a a a a
a a a a a a a a a a a a a a a a a a a a a a a a a a a a a a a a a a a a a a a a e e e a a a a a a a a a a a a a a a a a a a a a a a a a a a a a a a a a a a a a
a a a a a a a a a a a a a a a a a a a a a a a a a a a a a a a a a a a a a a a a a a a a a a a a a a a a a a a a a a a a a a a a a a a a a a a a a a a a a a a a
a a a a a a a a a a a a a a a a a a a a a a a a a a a a a a a a a a a a a a a a a a a a a a a a a a a a a a a a a a a a a a a a a a a a a a a a a a a a a a a a
a a a a a a a a a a a a a a a a a a a a a a a a a a a a a a a a a a a a a a a d d d d d a a a a a a a a a a a a a a a a a a a a a a a a a a a a a a a a a a a a
a a a a a a a a a a a a a a a a a a a a a a a a a a a a a a a a a a a a a a a d a a a a a a a a a a a a a a a a a a a a a a a a a a a a a a a a a a a a a a a a
a a a a a a a a a a a a a a a a a a a a a a a a a a a a a a a a a a a a a a a d a a a a a a a a a a a a a a a a a a a a a a a a a a a a a a a a a a a a a a a a
a a a a a a a a a a a a a a a a a a a a a a a a a a a a a a a a a a a a a a a d d a a a a a a a a a a a a a a a a a a a a a a a a a a a a a a a a a a a a a a a
a a a a a a a a a a a a a a a a a a a a a a a a a a a a a a a a a a a a a a a a d a a a a a a a a a a a a a a a a a a a a a a a a a a a a a a a a a a a a a a a
a a a a a a a a a a a a a a a a a a a a a a a a a a a a a a a a a a a a a a a a d a a a a a a a a a a a a a a a a a a a a a a a a a a a a a a a a a a a a a a a
a a a a a a a a a a a a a a a a a a a a a a a a a a a a a a a a a a a a a a a a d a a a a a a a a a a a a a a a a a a a a a a a a a a a a a a a a a a a a a a a
a a a a a a a a a a a a a a a a a a a a a a a a a a a a a a a a a a a a a a a a d a a a a a a a a a a a a a a a a a a a a a a a a a a a a a a a a a a a a a a a
a a a a a a a a a a a a a a a a a a a a a a a a a a a a a a a a a a a a a a a a d a a a a a a a a a a a a a a a a a a a a a a a a a a a a a a a a a a a a a a a
a a a a a a a a a a a a a a a l l l l l l l l l l l l l l l a a a a a a a a a a d a a a a a a a a a a a a a a a a a a a a a a a a a a a a a a a a a a a a a a a
a a a a a a a a a a a a a a a l l l l l l l l l l l l l l l a a a a a a a a a a d a a a a a a a a a a a a a l l l l l l l l l l l l l l l a a a a a a a a a a a
a a a a a a a a a a a a a a a l l l l l l l l l l l l l l l a a a a a a a a a d d a a a a a a a a a a a a a l l l l l l l l l l l l l l l a a a a a a a a a a a
a a a a a a a a a a a a a a a l l l l l l l l l l m l l l l a a a a a a a a a d a a a a a a a a a a a a a a l l l l l l l l l l l l l l l a a a a a a a a a a a
a a a a a a a a a a a a a a a l l l l l l l l l l m l l l l a a a a a a a a a d a a a a a a a a a a a a a a l l l l l l l l l l l l l l l a a a a a a a a a a a
a a a a a a a a a a a a a a a l l l l l l l l l l l l l l l a a a a a a a a a d a a a a a a a a a a a a a a l l l l l l l l l l l l l l l a a a a a a a a a a a
a a a a a a a a a a a a a a a l l l l l l l l l l l l l l l a a a a a a a a a d a a a a a a a a a a a a a a l l l l l l l l l l l l l l l a a a a a a a a a a a
a a a a a a a a a a a a a a a l l l l l l l l l l l l l l l a a a a a a a a a d a a a a a a a a a a a a a a l l l l l l l l l l l l l l l a a a a a a a a a a a
a a a a a a a a a a a a a a a l l l l l l l l l l l l l l l a a a a a a a a a d a a a a a a a a a a a a a a l l l l l l l l l l l l l l l a a a a a a a a a a a
a a a a a a a a a a a a a a a l l l l l l l l l l l l l l l a a a a a a a a a d a a a a a a a a a a a a a a l l l l l l l l l l l l l l l a a a a a a a a a a a
a a a a a a a a a a a a a a a l l l l l l l l l l l l l l l a a a a a a a a a d a a a a a a a a a a a a a a l l l l l l l l l l l l l l l a a a a a a a a a a a
a a a a a a a a a a a a a a a l l l l l l l l l l l l l l l a a a a a a a a a d d a a a a a a a a a a a a a l l l l l l l l l l l m m l l a a a a a a a a a a a
a a a a a a a a a a a a a a a l l l l l l l l l l l l l l l a a a a a a a a a a d a a a a a a a a a a a a a l l l l l l l l l l l l l l l a a a a a a a a a a a
a a a a a a a a a a a a a a a l l l l l l l l l l l l l l l a a a a a a a a a a d a a a a a a a a a a a a a l l l l l l l l l l l l l l l a a a a a a a a a a a
a a a a a a a a a a a a a a a l l l l l l l l l l l l l l l a a a a a a a a a a d a a a a a a a a a a a a a l l l l l l l l l l l l l l l a a a a a a a a a a a
a a a a a a a a a a a a a a a a a a a a a a a a a a a a a a a a a a a a a a a a a a a a a a a a a a a a a a l l l l l l l l l l l l l l l a a a a a a a a a a a
a a a a a a a a a a a a a a a a a a a a a a a a a a a a a a a a a a a a a a a a a a a a a a a a a a a a a a a a a a a a a a a a a a a a a a a a a a a a a a a a
a a a a a a a a a a a a a a a a a a a a a a a a a a a a a a a a a a a a a a a a a a a a a a a a a a a a a a a a a a a a a a a a a a a a a a a a a a a a a a a a
a a a a a a a a a a a a a a a a a a a a a a a a a a a a a a a a a a a a a a a a a a a a a a a a a a a a a a a a a a a a a a a a a a a a a a a a a a a a a a a a
a a a a a a a a a a a a a a a a a a a a a a a a a a a a a a a a a a a a a a a a a a a a a a a a a a a a a a a a a a a a a a a a a a a a a a a a a a a a a a a a
a a a a a a a a a a a a a a a a a a a a a a a a a a a a a a a a a a a a a a a a a a a a a a a a a a a a a a a a a a a a a a a a a a a a a a a a a a a a a a a a
a a a a a a a a a a a a a a a a a a a a a a a a a a a a a a a a a a a a a a a a a a a a a a a a a a a a a a a a a a a a a a a a a a a a a a a a a a a a a a a a
a a a a a a a a a a a a a a a a a a a a a a a a a a a a a a a a a a a a a a a a a a a a a a a a a a a a a a a a a a a a a a a a a a a a a a a a a a a a a a a a
a a a a a a a a a a a a a a k k k k k k k k k a a k k k k k k a a a a a a a a a a a a a a a a a a a a a a a a a a a a a a a a a a a a a a a a a a a a a a a a a
a a a a a a a a a a a a a a k l l l l l l l l l l l l l l l k k a a a a a a a a a a a a a a a a a a a a a a a a a a a a a a a a a a a a a a a a a a a a a a a a
a a a a a a a a a a a a a a k l l l l l l l l l l l l l l l l k a a a a a a a a a a a a a a a a a a a a a a a a a a a a a a a a a a a a a a a a a a a a a a a a
a a a a a a a a a a a a a a k l l l l l l l l l l l l l l l l k a a a a a a a a a a a a a a a a a a a a a a a a a a a a a a a a a a a a a a a a a a a a a a a a
a a a a a a a a a a a a a a k l l l l l l l l l l l l m l l l k a a a a a a a a a a a a a a a a a a a a a a a a a a a a a a a a a a a a a a a a a a a a a a a a
a a a a a a a a a a a a a a k l l l l l l l l l l l l l l l l k a a a a a a a a a a a a a a a a a a a a a a a a a a a a a a a a a a a a a a a a a a a a a a a a
a a a a a a a a a a a a a a k l l l l l l l l l l l l l l l l k a a a a a a a a a a a a a a k k k k k k k k k k l l k k k k k a a a a a a a a a a a a a a a a a
a a a a a a a a a a a a a a k l l l l l l l l l l l l l l l l k a a a a a a a a a a a a a a k d d l l l l l k l l l l l l l k a a a a a a a a a a a a a a a a a
a a a a a a a a a a a a a a k l l l l l l l l l l l l l l l l k a a a a a a a a a a a a a a k d d l l l l l k l l l l l l l k a a a a a a a a a a a a a a a a a
a a a a a a a a a a a a a a k l l l l l l l l l l l l l l l l k a a a a a a a a a a a a a a k l l l l l l l k l l l l l l l k a a a a a a a a a a a a a a a a a
a a a a a a a a a a a a a a k l l l l l l l l l l l l l l l l k a a a a a a a a a a a a a a k l l l l l l l k l l l l l l l k a a a a a a a a a a a a a a a a a
a a a a a a a a a a a a a a k l l l l l l l l l l l l l l l l k a a a a a a a a a a a a a a k l l l l l l k k k k k k l k k k a a a a a a a a a a a a a a a a a
a a a a a a a a a a a a a a k l l l l l l l l l l l l l l l l k a a a a a a a a a a a a a a k l l l l l l l l l l l l l l l k a a a a a a a a a a a a a a a a a
a a a a a a a a a a a a a a k l l l l l l l l l l l l l l l l k a a a a a a a a a a a a a a k l l l l l l k l l l l l l l l k a a a a a a a a a a a a a a a a a
a a a a a a a a a a a a a a k l l l l l l l l l l l l l l d d k a a a a a a a a a a a a a a k l l l l l l k l l l l l l l l k a a a a a a a a a a a a a a a a a
a a a a a a a a a a a a a a k l l l l l l l l l l l l l l d d k a a a a a a a a a a a a a a k k k k k k k k l l l l l l l l k a a a a a a a a a a a a a a a a a
a a a a a a a a a a a a a a k k k k k k k k k k k k k k k k k k a a a a a a a a a a a a a a k l l l l k l l l l l l l l l l k a a a a a a a a a a a a a a a a a
a a a a a a a a a a a a a a a a a a a a a a a a a a a a a a a a a a a a a a a a a a a a a a k l l l l k l l l l k k k k l k k a a a a a a a a a a a a a a a a a
a a a a a a a a a a a a a a a a a a a a a a a a a a a a a a a a a a a a a a a a a a a a a a k l l l l k l l l l k l l l l l k a a a a a a a a a a a a a a a a a
a a a a a a a a a a a a a a a a a a a a a a a a a a a a a a a a a a a a a a a a a a a a a a k l l l l k l l l l k l m l l l k a a a a a a a a a a a a a a a a a
a a a a a a a a a a a a a a a a a a a a a a a a a a a a a a a a a a a a a a a a a a a a a a k l l l l l l l l l k l l l l l k a a a a a a a a a a a a a a a a a
a a a a a a a a a a a a a a a a a a a a a a a a a a a a a a a a a a a a a a a a a a a a a a k l l l l k l l l l k k l l l l k a a a a a a a a a a a a a a a a a
a a a a a a a a a a a a a a a a a a a a a a a a a a a a a a a a a a a a a a a a a a a a a a k k k k k k k k k k k k k k k k k a a a a a a a a a a a a a a a a a
a a a a a a a a a a a a a a a a a a a a a a a a a a a a a a a a a a a a a a a a a a a a a a a a a a a a a a a a a a a a a a a a a a a a a a a a a a a a a a a a