A A A A A A A A A A A A A A A A A A A A A A A A A A I I I I I I I I I A A A A A A A A
A A A A A A A A A A A A A I I I I I I I I I A A A I I I I I I I I I I A A A A A A A A
A A A A A A A A A A A A A I I I I I I I I I I I I I I I I I I I I I I A A A A A A A A
A A A A A A A A A A A A A I I I I I I I I I I I I I I I I I I I I I I A A A A A A A A
A A A A A A A A A A A I I I I I I I I I I I I I I I I I I I I I I I I A A A A A A A A
A A A A A A A A A A I I I I I I I I I I I I I I I I I I I I I I I I I D D D D D D A A
A A A A A A A A A I I I I I I I I I I I I I I I I I I I I I I I I I I D D D D D D D D
A A A A A A A A I I I I I I I I I I I I I I I I I I I I I I I I I I I D D D D D D D D
A A A A A A A A I I I I I I I I I I I I I I I I I I I I I I I I I D D D D D D D D D D
A A A A A A A A I I I I I I I I I I I I I I I I I I I I I I I I D D D D D D D D D D D
A A A A A A A A I I I I I I I I I I I I I I I I I I I I I I F F F F F F F F F F F F F
A A A A A A A A I I I I I I I I I I I I I I I I I I I I I I D D D D D D D D D D D D D
A A A A A A A A I I I I I I I I I I I I I I I I I I I I I D D D D D D D D D D D D D D
A A A A A A A A I I I I I I I I I I I I I I I I I I I I B B B B B C C D D D D D D D D
A A A A A A I I I I I I I I I I I I I I I I I I I I I B B B B B B C C C C C C C D D D
A A A A I I I I I I I I I I I I I I I I I I I I I B B B B B B B B C C C C C C C C B B
A A I I I I I I I I I I I I I I I I I I I I B B B B B B B B B B B C C C C C C C C B B
A I I I I I I I I I I I I I I I I I I I I B B B B B B B B B B B B C C C C C C C C C B
A I I I I I I I I I I I I I I I I I I B B B B B B B B B B B B C C C C C C C C C C C B
A I I I I I I I I I I I I I I I I I I B B B B B B B B B B B C C C C C C C C C C C C B
A I I I I I I I I I I I I I I I I I I B B B B B B B B B B B C C C C C C C C C C C C C
A I I I I I I I I I I I I I I I I B B B B B B B B B B B B B C C C C C C C C C C C C C
C C C I I I I I I I I I I I I I B B B B B B B B B B B B B B C C C C C C C C C C C C C
C C C C I I I I I I I I I I B B B B B B B B B B B B B B B B C C C C C C C C C C C C C
C C C C C I I I I I I I B B B B B B B B B B B B B B B B B B C C C C C C C C C C C C C
C C C C C C C I I I A A B B B B B B B B B B B B B B B B B C C C C C C C C C C C C C C
C C C C C C C C A A A A B B B B B B B B B B B B B B B B B C C C C C C C C C C C C C C
A C C C C C C C C A A A B B B B B B B B B B B B B B B A A C C C C C C C C C C C C C C
A A A A A C C C C C A A B B B B B B B B B B B B B B B A A C C C C C C C C C C C C C A
A A A A A A A A C C C A A B B B B B B B B B B B B B B A A C C C C C C C C C C C C B A
A A A A A A A A A C C C C A A B B B B B B B B B A A A A A C C C C C C C C C C B B B A
A A A A A A A A A C C C C C A B B B B B B B B A A A A A A C C C C C C C C C A A A A A
A A A A A A A A A A A C C C A A A A A A A A A A A A A A C C C C C C C C C C A A A A A
A A A A A A A A A A A A A A A A A A A A A A A A A C C C C C C C C C C C C C A A A A A
A A A A A A A A A A A A A A A A A A A A A A A C C C C C C C C C C C C C C C A A A A A
A A A A A A A A A A A A A A A A A A A A A C C C C C C C C C C C C C C C C C A A A A A
A A A A A A A A A A A A A A A A A A A C C C C C C C C C C C C C C C C C C C A A A A A
A A A A A A A A A A A A A A A A A A A C C C C C C C C C C C C C C C C C C C A A A A D
A A A A A A A A A A A A A A A A A A A C C C C C C C C C C C C C C C C C C A A A A A D
A A A A A A A A A A A A A A A A A A A C C C C C C C C C C C C C C C C C A A A A A A D
A A A A A A A A A A A A A A A A A A A C C C C C C C C C C C C C C C C A A A A A A A D
A A A A A A A A A A A A A A A A A A A C C C C C C C C C C C C C C C C A A A A A A A D
A A A A A A A A A A A A A A A A A A A C C C C C C C C C C C C C C C C A A A A A A A D
A A A A A A A A A A A A A A A A A A A C C C C C C C C C C C C C C C C A A A A A A A D
A A A A A A A A A A A A A A A A A A A A A A A A A A A A A A A A A A A A A A A A A A D
A A A A A A A A A A A A A A A A A A A A A A A A A A A A A A A A A A A A A A A A A A D
A A A A A A A A A A A A A A A A A A A A A A A A A A A A A A A A A A A A A A A A A A A
A A A A A A A A A A A A A A A A A A A A A A A A A A A A A A A A A A A A A A A A A A A
A A A A A A A A A A A A A A A A A A A A A A A A A A A A A A A A A A A A A A A A A A A
A A A A A A A A A A A A A A A A A A A A A A A A A A A A A A A A A A A A A A A A A A A