a a a a a a a a a a a a a a a a a a a a a a a a a a a a a a a a a a a a a a a a a a a a a a a a a a a a a a a a a a a a a a a a a a a a a a a a a a a a a a a a a a a a a a a a a a
a a a a a a a a a a a a a a a a a a a a a a a a a a a a a a a a a a a a a a a a a a a a a a a a a a a a a a a a a a a a d d d d d d d d a a a a a a a a a a a a a a a a a a a a a a
a a a a a a a a a a a a a a a a a a a a a a a a a a a a a a a a a a a a a a a a a a a a a a a a a a d d d d d d d d d d d d d d d d d d a a a a a a a a a a a a a a a a a a a a a a
a a a a a a a a a a a a a a a a a a a a a a a a a a a a a a a a a a a a a a a a d d d d d d d d d d d d d d d d d d d d d d d d d d d d d a a a a a a a a a a a a a a a a a a a a a
a a a a a a a a a a a a a a a a a a a a a a a a a a a a a a a a a a a a a a a a a a a a a a a a a a a a a a a a a a a a a a a a a a d d d a a a a a a a a a a a a a a a a a a a a a
a a a a a k k k k k k k k k k k k k k k k k k k k k k k k k k k a a a a a a a a a a a a a a a a a a a a a a a a a a a a a a a a a a a a d d a a a a a a a j j j j j j j j j a a a a
a a a a a k l l l l l l l l l l l l l l l l l k k l l l l l l k a a a a a a a a a a a a a a a a a a a a a a a a a a a a a a a a a a a a a d a a a a a a j j j j j j j j j j j a a a
a a a a a k l l l l l l l l l l l l l l l l l l k l l m m l l k a a a a a a a a k k k k k k k k k k k k k k k k k k k k k k k k k a a a a d d a a a a a j j l l l l l l l j j a a a
a a a a a k l l l l l l l l l l l l l l l l l l k l l l l l l k a a a a a a a a k l l l l l l l k l l l l l l l l k l l l l l l k a a a a a d a a a a a j j l d d d l l l j j a a a
a a a a a k l l l l l l l l l l l l l l l l l l l l l l l l l k a a a a a a a a k l l l l l l l l l l l l l l l l k l l l l l l k a a a a a d a a a a a j j l d d d d d l j j a a a
a a a a a k k k k k k k k k k k l l l l l l l l l l l l l l l k a a a a a a a a k l l l l l l l l l l l l l l l l k l l l l l l k a a a a a f a a a a a j j l d d d d d l j j a a a
a a a a a k l l l l l l l l l l l l l l l l l l k l l l l l l k a a a a a a a a k l l l l l l l k l l l l l l l l k l l m l l l k a a a a a d a a a a a j j l d d d d d l j j a a a
a a a a a k l l l l l l l l l l l l l l l l l l k l l l l l l k a a a a a a a a k l l l l l l l k l l l l l l l l k l l l l l l k a a a a a d a a a a a j j l f f f f f l j j a a a
a a a a a k l l l l l l l l l l l l l l l l l l k l l l l l l k a a a a a a a k k l l l l l l l k l l l l l l l l k l l l l l l k a a a a a d a a a a a j j l d d d d d l j j a a a
a a a a a k l l l l l l l l l l l l l l l l l l k l l l l l l k a a a a a a a k l l l l l l l l k l l l l l l l l k l l l l l l k a a a a a d a a a a a j j l d d d d d l j j a a a
a a a a a k l l l l l l l l l l l l l l l l l l k l l l l l l k a a a a a a a k l l l l l l l l k l l l l l l l l k l l l l l l k a a a a a d a a a a a j j l l d d d l l j j a a a
a a a a a k l l l l l l l l l l l l l l l l l l k l l l l l l k a a a a a a a k l l l m l l l l k l l l l l l l l k l l l l l l k a a a a a d a a a a a j j l l l l l l j j j a a a
a a a a a k l l l l l l l l l l l l l l l l k k k k k k k k k k a a a a a a a k l l l l l l l l k l l l l l l l l k l l l l l l k a a a a a d a a a a a j j j l l l l l j j a a a a
a a a a a k l l l l l l l l l l l l l l l k k l l l l l l l l k a a a a a a a k l l l l l l l l k l l l l l l l l k l l l l l l k a a a a a d a a a a a a j j l j j j j j j a a a a
a a a a a k l l l l l l l l l l l l l l l k l l l l l l l l l k a a a a a a a k l l l l l l l k k l l l l l l l l l l l l l l l k a a a a a d a a a a a a j j j j j j j j a a a a a
a a a a a k l l l l l l l l l l j j l l l k l l l l l l l l l k a a a a a a a k k k k k k k k k k k k k l l k k k k k k k k k k k a a a a a f a a a a a a a j j a a a a a a a a a a
a a a a a k l l l l l l l l l l j j l l l l l l l l l l l l l k a a a a a a a k l l l l k l l l l l l l l l l l l l l l l l l l k a a a a a d a a a a a a a j j a a a a a a a a a a
a a a a a k l l l l l l l l l l j j l l l l l l l l l l l l l k a a a a a a a k l l l l k l l l l l l l l l l l l l l l l l l l k a a a a a d a a a a a a a j j a a a a a a a a a a
a a a a a k l l l l l l l l l l j j l l l l l l l l l l l l l k a a a a a a a k l l l l k l l l l l l l l l l l l l l l l l l l k a a a a a d a a a a a a a j j a a a a a a a a a a
a a a a a k k k k k k k k k k k j j k k k k k k k k k k k k k k a a a a a a a k l l l l k l l l l l l l l l l l l l l l l l l l k a a a a a d a a a a a a a j j a a a a a a a a a a
a a a a a a a a a a a a a a a a j j a a a a a a a a a a a a a a a a a a a a a k l l l l k l l l l l l l l l l l l l l l l l l l k a a a a a d a a a a a a a j j a a a a a a a a a a
a a a a a a a a a a a a a a a a j j a a a a a a a a a a a a a a a a a a a a a k l l l l k l l l l l l l l l l l l l l l l l l l k a a a a a d a a a a a a a j j a a a a a a a a a a
a a a a a a a a a a a a a a a a j j a a a a a a a a a a a a a a a a a a a a a k l l l l k k l l l l l l l l l l l l l k k k k k k a a a a a d a a a a a a a j j a a a a a a a a a a
a a a a a a a a a a a a a a a a j j b b b b a a a a a a a a a a a a a a a a a k l l l l l k l l l l l l l l l k k k k k l l l k a a a a a a a a a a a a a a j j a a a a a a a a a a
a a a a a a a a a a a a a a a a j j b b b b b b a a a a a a a a a a a a a a a k l l l l l l l l l l l l l l l l l l l l l l l k a a a a a a a a a a a a a a j j a a a a a a a a a a
a a a a a a a a a a a a a a a j j j b b b b b b b a a a a a a a a a a a a a a k l l l l l k l l l l l l j j l l l l l l l l l k a a a a a a a a a a a a a a j j a a a a a a a a a a
a a a a a a a a a a a a a a a j j b b b b b b b b b a a a a a a a a a a a a a k k k k k k k k k k k k k j j k k k k k k k k k k a a a a a a a a a a a a a a j j a a a a a a a a a a
a a a a a a a a a a a a a a a j j b b b b b b b b b b b a a a a a a a a a a a a a a a a a a a a a a k k j j a a a a a a a a a a a a a a a a a a a a a a a a j j a a a a a a a a a a
a a a a a a a a a a a a a a a j j b b b b b b b b b b b b b b a a a a a a a a a a a a a a a a a a a a a j j a a a a a a a a a a a a a a a a a a a a a a a a j j a a a a a a a a a a
a a a a a a a a a a a a a a a j j b b b b b b b b b b b b b b b a a a a a a a a a a a a a a a a a a a a j j a a a a a a a a a a a a a a a a a a a a a a a a j j a a a a a a a a a a
a e j j j j j j j j j j j j j j j j j j j j j j j j j j j j j j j j j j j j j j j j j j j j j j j j j j j j j j j j j j j j j j j j j j j j j j j j j j j j j j j j j j j j j e a a
a e j j j j j j j j j j j j j j j j j j j j j j j j j j j j j j j j j j j j j j j j j j j j j j j j j j j j j j j j j j j j j j j j j j j j j j j j j j j j j j j j j j j j j e a a
a e j j j j j j j j j j j j j j j j j j j j j j j j j j j j j j j j j j j j j j j j j j j j j j j j j j j j j j j j j j j j j j j j j j j j j j j j j j j j j j j j j j j j j e a a
a a a a a a a a a a a a a a a a a a a a a a a a a a j j b b b b b b b b b b b b b a a a a a a a a a a a a a a a a a a a a a a a b b b b b b b b b b j j a a a a a a a a a a j a a a
a a a a a a a a a a a a a a a a a a a a a a a a a a j j b b b b b b b b b b b b b a a a a a a a a a a a a a a a a a a a a a a a b b b b b b b b b b j j a a a a b b b b a a a a a a
a a a a a a a a a a a a a a a a a a a a a a a a a a j j b b b b b b b b b b b b a a a a a a a a a a a a a a a a a a a a a a a a a b b b b b b b b b j j j a a b b b b b b b a a a a
a a a a a a a a a a a a a a a a a a a a a a a a a a j j b b b b b b b b b b b a a a a a a a a a a a a a a a a a a a a a a a a a a a b b b b b b b b j j j j j j j b b b b b b a a a
a a a a a a a a a a a a a a a a a a a a a a a a a a j j b b b b b b b b b b a a a a a a a a a a a a a a a a a a a a a a a a a a a a a a b b b b b b j j j j j j j b b b b b b a a a
a a a a a a a a a a a a a a a a a a a a a a a a a a j j b b b b b b b b a a a a a a a a a a a a a a a a a a a a a a a a a a a a a a a a a a a b b b j j j a a b b b b b b b b a a a
a a a a a a a a a a a a a a a a a a a a k k k k k k j j k k k k k k k k k a a a a a a a a a a a a a a a a a a a a a a a a a a a a a a a a a a a a a j j a a a b b b b b b b b a a a
a a a a a a a a a a a a a a a a a a k k k l l l k l j j l l l l l l l l k a a a a a a a a a a a a a a a a a a a a a a a a a a a a a a a a a a a a a j j a a a a a b b b b b a a a a
a a a a a a a a a a a a a a a a a a k l l l l l k l j j l l l l l l l l k a a a a a a a a a d d d d d d d d d d d a a a a a a a a a a a a a a a a a j j a a a a a a a a a a a a a a
a a a a a a a a a a a a a a a a a a k l m l l l l l j j l l l l l l l l l k a a a a a a a d d d d d d d d d d d d d a a a a a a a a a a a a a a a a j j a a a a a a a a a a a a a a
a a a a a a a a a a a a a a a a a a k l l l l l k l l l l l l l l l l l l k a a a a a a d d d d d d d d d d d d d d d a a a a a a a a a a a a a a a j j a a a a a a a a a a a a a a
a a a a a a a a a a a a a a a a a a k l l l l l k l l l l l l l l l l l l k a a a a a a d d d d d d d d d d d d d d d d a a a a a a a a a a a a a a j j k k k k k k k k k k a a a a
a a a a a a a a a a a a a a a a a a k l l l l l k l l l l l l l l l l l l k a a a a a d d d d d d d d d d d d d d d d d d a a a a a k k k k k k k k j j l l l l l k l l l k a a a a
a a a a a a a a a a a a a a a a a a k k k k k k k l l l l l l l l l l l l k a a a a a d d d d d d d d a a a a d d d d d d a a a a a k l l l l l l l j j l l l l l k l l l k a a a a
a a a a a a a a a a a a a a a a a a k l l l l l l l l l l l l l l l l l l k a a a a a d d d d d d d d a a i a d d d d d d d a a a a k k l l l l l l j j l l l l l k l l l l k a a a
a a a a a a a a a a a a a a a a a a k l l l l l l l l l k k k k k k l l k k a a a a a f f f f f f f f a a a a d d d d d d d a a a a a k l l l l l l j j l l l l l k l l l l k a a a
a a a a a a a a a a a a a a a a a a k l l l l l l l l l k l l l l l l l l k a a a a a f d d d d d d d a a a a d d d d d d d a a a a a k l l l l l l j j l l l l l k l l l l k a a a
a a a a a a a a a a a a a a a a a a k l l l l l l l l l k l l l l l l l l k a a a a a a d d d d d d d d d d d d d d d d d d a a a a a k l l l l l l j j l l l l l k l l l l k a a a
a a a a a a a a a a a a a a a a a a k l l l l l l l l l k l l l l l l l l k a a a a a a d d d d d d d d d d d d d d d d d d a a a a a k k l l l l l l l l l l l l k k l l l k a a a
a a a a a a a a a a a a a a a a a a k l l l l l l l l l k l l l l l m l l k a a a a a a a d d d d d d d d d d d d d d d d d a a a a a a k l l l l l l l l l l l l l l l l l k a a a
a a a a a a a a a a a a a a a a a a k l l l l l l l l l k k l l l l l l l k a a a a a a a d d d d d d d d d d d d d d d d a a a a a a a k k k k k k k k k k k k l l l l l l k a a a
a a a a a a a a a a a a a a a a a a k k k k k l l l l l l k l l l l l l l k a a a a a a a a d d d d d d d d d d d d d d d a a a a a a a k l l l l l l l l l l k k k k l l l k a a a
a a a a a a a a a a a a a a a a a a a a a a k k k k k k k k k l l l l l l k a a a a a a a a a a d d d d d d d d d d d d a a a a a a a a k l l l l l l l l l l l l l l l l l k a a a
a a a a a a a a a a a a a a a a a a a a a a a a a a a a a a a k k k k k k k a a a a a a a a a a a a d d d d d d d d d a a a a a a a a a k l l l l l m l l l l l l l l l l l k a a a
a a a a a a a a a a a a a a a a a a a a a a a a a a a a a a a a a a a a a a a a a a a a a a a a a a a a a a a a a a a a a a a a a a a a k l l l l l l l l l l l l l l l l l k a a a
a a a a a a a a a a a a a a a a a a a a a a a a a a a a a a a a a a a a a a a a a a a a a a a a a a a a a a a a a a a a a a a a a a a a k k l l l l l l l l l l l l l l l l k a a a
a a a a a a a a a a a a a a a a a a a a a a a a a a a a a a a a a a a a a a a a a a a a a a a a a a a a a a a a a a a a a a a a a a a a a k k k k k k k k k k k k k k k k k k a a a
a a a a a a a a a a a a a a a a a a a a a a a a a a a a a a a a a a a a a a a a a a a a a a a a a a a a a a a a a a a a a a a a a a a a a a a a a a a a a a a a a a a a a a a a a a
a a a a a a a a a a a a a a a a a a a a a a a a a a a a a a a a a a a a a a a a a a a a a a a a a a a a a a a a a a a a a a a a a a a a a a a a a a a a a a a a a a a a a a a a a a
a a a a a a a a a a a a a a a a a a a a a a a a a a a a a a a a a a a a a a a a a a a a a a a a a a a a a a a a a a a a a a a a a a a a a a a a a a a a a a a a a a a a a a a a a a
a a a a a a a a a a a a a a a a a a a a a a a a a a a a a a a a a a a a a a a a a a a a a a a a a a a a a a a a a a a a a a a a a a a a a a a a a a a a a a a a a a a a a a a a a a
a a a a a a a a a a a a a a a a a a a a a a a a a a a a a a a a a a a a a a a a a a a a a a a a a a a a a a a a a a a a a a a a a a a a a a a a a a a a a a a a a a a a a a a a a a
