A B C D E F G H I J K L M N O P Q R S T U V W X Y Z [ \ ] ^ _ R R R R R R R R R R R R R R R R R R R R R R R R R R R R R R R R R R R R R R R R R R R R R R R R R
R R R R R R R R R R R R R R R R R R R R R R R R R R R R R R R R R R R R R R R R R R R R R R R R R R R R R R R R R R R R R R R R R R R R R R R R R R R R R R R R
R R R R R R R R R R R R R R R R R R R R R R R R R R R R R R R R R R R R R R R R R R R R R R R R R R R R R R R R R R R R R R R R R R R R R R R R R R R R R R R R
R R R R R R R R R R R R R R R R R R R R R R R R R R R R R R R R R R R R R R R R R R R R R R R R R R R R R R R R R R R R R R R R R R R R R R R R R R R R R R R R
R R R R R R R R R R R R R R R R R R R R R R R R R R R R R R R R R R R R R R R R R R R R R R R R R R R R R R R R R R R R R R R R R R R R R R R R R R R R R R R R
R R R R R R R R R R R R R R R R R R R R R R R R R R R R R R S S S S S R R R R R R R R R R R R R R R R R R R R R R R R R R R R R R R R R R R R R R R R R R R R R
R R R R R R R R R R R R R R R R R R R R R R R R R R R R R R S S S S S S S R R R R R R R R R R R R R R R R R R R R R R R R R R R R R R R R R R R R R R R R R R R
R R R R R R R R R R R R R R R R R R R R R R R R R R R R R R S S S S S S S S R R R R R R R R R R R R R R R R R R R R R R R R R R R R R R R R R R R R R R R R R R
R R R R R R R R R R R R R R R R R R R R R R R R R R R R R R S S S S S S S S S R R R R R R R R R R R R R R R R R R R R R R R R R R R R R R R R R R R R R R R R R
R R R R R R R R R R R R R R R R R R R R R R R R R R R R R R R R S S S S S S S R R R R R R R R R R R R R R R R R R R R R R R R R R R R R R R R R R R R R R R R R
R R R R R R R R R R R R R R R R R R R R R R R R R R R R R R R R R S S S S S S R R R R R R O P P P P P P P P P P P P P P P P P P P P P Q R R R R R R R R R R R R
R R R R R R R R R R R R R R R R R R R R R R R R R R R R R R R R R R S S S S S R R R R R R V W W W W W W W W W W W W W W W W W W W W W X R R R R R R R R R R R R
R R R R R R R R R R R R R R R R R R R R R R R R R R R R R R R R R R S S S S S R R R R R R V W W W W W W W W W W W W W W W W W W W W W X R R R R R R R R R R R R
R R R R R R R R R R R R R R R R R R R R R R R R R R R R R R R R R R S S S S S R R R R R R V W W W W W W W W W W W W W W W W W W W W W X R R R R R R R R R R R R
R R R R R R R R R R R R R R R R R R R R R R R R R R R R R R R R R R S S S S S R R R R R R V W W W W W W W W W W W W W W W W W W W W W X R R R R R R R R R R R R
R R R R R R R R R R R R R R R O P P P P P P P P P P P Q R R R R R R S S S S S R R R R R R V W W W W W W W W W W W W W W W W W W W W W X R R R R R R R R R R R R
R R R R R R R R R R R R R R R V W W W W W W W W W W W X R R R R R R S S S S S S R R R R R V W W W W W W W W W W W W W W W W W W W W W X R R R R R R R R R R R R
R R R R R R R R R R R R R R R V W W W W W W W W W W W X R R R R R R S S S S S S R R R R R V W W W W W W W W W W W W W W W W W W W W W X R R R R R R R R R R R R
R R R R R R R R R R R R R R R V W W W W W W W W W W W X R R R R R R S S S S S S R R R R R V W W W W W W W W W W W W W W W W W W W W W X R R R R R R R R R R R R
R R R R R R R R R R R R R R R V W W W W W W W W W W W X R R R R R R S S S S S S R R R R R V W W W W W W W W W W W W W W W W W W W W W X R R R R R R R R R R R R
R R R R R R R R R R R R R R R V W W W W W W W W W W W X R R R R R R S S S S S S R R R R R V W W W W W W W W W W W W W W W W W W W W W X R R R R R R R R R R R R
R R R R R R R R R R R R R R R V W W W W HBAA W W W W W W Z Y Y Y Y Y Y Y Y Y Y Y Y Y Y Y Y Y [ W W W W W W W W W W W W W W W W W W W W W X R R R R R R R R R R R R
R R R R R R R R R R R R R R R V W W W W W W W W W W W X R R R R R R S S S S S S R R R R R V W W W W W W W W W W W W W W W W W W W W W X R R R R R R R R R R R R
R R R R R R R R R R R R R R R V W W W W W W W W W W W X R R R R R R S S S S S S R R R R R V W W W W W W W W W W W W W W W W W W W W W X R R R R R R R R R R R R
R R R R R R R R R R R R R R R V W W W W W W W W W W W X R R R R R R S S S S S S R R R R R V W W W W W W W W W W W W W W W W W W W W W X R R R R R R R R R R R R
R R R R R R R R R R R R R R R V W W W W W W W W W W W X R R R R R R S S S S S S R R R R R V W W W W W W W W W W W W W W W W W W W W W X R R R R R R R R R R R R
R R R R R R R R R R R R R R R V W W W W W W W W W W W X R R R R R R S S S S S S R R R R R V W W W W W W W W W W W W W W W W W W W W W X R R R R R R R R R R R R
R R R R R R R R R R R R R R R V W W W W W W W W W W W X R R R R R R S S S S S S R R R R R V W W W W W W W W W W W W W W W W W W W W W X R R R R R R R R R R R R
R R R R R R R R R R R R R R R ] ^ ^ ^ ^ ^ ^ ^ ^ ^ ^ ^ _ R R R R R R S S S S S S R R R R R V W W W W W W W W W W W W W W W W W W W W W X R R R R R R R R R R R R
R R R R R R R R R R R R R R R R R R R R R R R R R R R R R R R R R R S S S S S R R R R R R V W W W W W W W W W W W W W W W W W W W W W X R R R R R R R R R R R R
R R R R R R R R R R R R R R R R R R R R R R R R R R R R R R R R R R S S S S S R R R R R R ] ^ ^ ^ ^ ^ ^ ^ ^ ^ ^ ^ ^ ^ ^ ^ ^ ^ ^ ^ ^ ^ _ R R R R R R R R R R R R
R R R R R R R R R R R R R R R R R R R R R R R R R R R R R R R R R R S S S S S R R R R R R R R R R R R R R R R R R R R R R R R R R R R R R R R R R R R R R R R R
R R R R R R R R R R R R R R R R R R R R R R R R R R R R R R R R R R S S S S S R R R R R R R R R R R R R R R R R R R R R R R R R R R R R R R R R R R R R R R R R
R R R R R R R R R R R R R R R R R R R R R R R R R R R R R R R R R R S S S S S R R R R R R R R R R R R R R R R R R R R R R R R R R R R R R R R R R R R R R R R R
R R R R R R R R R R R R R R R R R R R R R R R R R R R R R R R R R R S S S S S S R R R R R R R R R R R R R R R R R R R R R R R R R R R R R R R R R R R R R R R R
R R R R R R R R R R R R R R R R R R R R R R R R R R R R R R R R R R S S S S S S R R R R R R R R R R R R R R R R R R R R R R R R R R R R R R R R R R R R R R R R
R R R R R R R R R R R R R R R R R R R R R R R R R R R R R R R R R R S S S S S S R R R R R R R R R R R R R R R R R R R R R R R R R R R R R R R R R R R R R R R R
R R R R R R R R R R R R R R R R R R R R R R R R R R R R R R R R R R S S S S S S S R R R R R R R R R R R R R R R R R R R R R R R R R R R R R R R R R R R R R R R
R R R R R R R R R R R R R R R R R R R R R R R R R R R R R R R R R R R S S S S S S R R R R R R R R R R R R R R R R R R R R R R R R R R R R R R R R R R R R R R R
R R R R R R R R R R R R R R R R R R R R R R R R R R R R R R R R R R R S S S S S S R R R R R R R R R R R R R R R R R R R R R R R R R R R R R R R R R R R R R R R
R R R R R R R R R R R R R R R R R R R R R R R R R R R R R R R R R R R S S S S S S R R R R R R R R R R R R R R R R R R R R R R R R R R R R R R R R R R R R R R R
R R R R R R R R R R R R R R R R R R R R R R R R R R R R R R R R R R R S S S S S S S R R R R R R R R R R R R R R R R R R R R R R R R R R R R R R R R R R R R R R
R R R R R R R R R R R R R R R R R R R R R R R R R R R R R R R R R R R S S S S S S S S R R R R R R R R R R R R R R R R R R R R R R R R R R R R R R R R R R R R R
R R R R R R R R R R R R R R R R R R R R R R R R R R R R R R R R R R R R S S S S S S S R R R R R R R R R R R R R R R R R R R R R R R R R R R R R R R R R R R R R
R R R R R R R R R R R R R R R R R R R R R R R R R R R R R R R R R R R R S S S S S S S S R R R R R R R R R R R R R R R R R R R R R R R R R R R R R R R R R R R R
R R R R R R R R R R R R R R R R R R R R R R R R R R R R R R R R R R R R R S S S S S S S R R R R R R R R R R R R R R R R R R R R R R R R R R R R R R R R R R R R
R R R R R R R R R R R R R R R R R R R R R R R R R R R R R R R R R R R R R R R R S S S S R R R R R R R R R R R R R R R R R R R R R R R R R R R R R R R R R R R R
R R R R R R R R R R R R R R R R R R R R R R R R R R R R R R R R R R R R R R R R R R R R R R R R R R R R R R R R R R R R R R R R R R R R R R R R R R R R R R R R
R R R R R R R R R R R R R R R R R R R R R R R R R R R R R R R R R R R R R R R R R R R R R R R R R R R R R R R R R R R R R R R R R R R R R R R R R R R R R R R R
R R R R R R R R R R R R R R R R R R R R R R R R R R R R R R R R R R R R R R R R R R R R R R R R R R R R R R R R R R R R R R R R R R R R R R R R R R R R R R R R
R R R R R R R R R R R R R R R R R R R R R R R R R R R R R R R R R R R R R R R R R R R R R R R R R R R R R R R R R R R R R R R R R R R R R R R R R R R R R R R R
R R R R R R R R R R R R R R R R R R R R R R R R R R R R R R R R R R R R R R R R R R R R R R R R R R R R R R R R R R R R R R R R R R R R R R R R R R R R R R R R
R R R R R R R R R R R R R R R R R R R R R R R R R R R R R R R R R R R R R R R R R R R R R R R R R R R R R R R R R R R R R R R R R R R R R R R R R R R R R R R R
R R R R R R R R R R R R R R R R R R R R R R R R R R R R R R R R R R R R R R R R R R R R R R R R R R R R R R R R R R R R R R R R R R R R R R R R R R R R R R R R
R R R R R R R R R R R R R R R R R R R R R R R R R R R R R R R R R R R R R R R R R R R R R R R R R R R R R R R R R R R R R R R R R R R R R R R R R R R R R R R R
R R R R R R R R R R R R R R R R R R R R R R R R R R R R R R R R R R R R R R R R R R R R R R R R R R R R R R R R R R R R R R R R R R R R R R R R R R R R R R R R
R R R R R R R R R R R R R R R R R R R R R R R R R R R R R R R R R R R R R R R R R R R R R R R R R R R R R R R R R R R R R R R R R R R R R R R R R R R R R R R R
R R R R R R R R R R R R R R R R R R R R R R R R R R R R R R R R R R R R R R R R R R R R R R R R R R R R R R R R R R R R R R R R R R R R R R R R R R R R R R R R
R R R R R R R R R R R R R R R R R R R R R R R R R R R R R R R R R R R R R R R R R R R R R R R R R R R R R R R R R R R R R R R R R R R R R R R R R R R R R R R R
R R R R R R R R R R R R R R R R R R R R R R R R R R R R R R R R R R R R R R R R R R R R R R R R R R R R R R R R R R R R R R R R R R R R R R R R R R R R R R R R
