A A A A A A A A A A A A A A A A A A A A A A A A A A A A A A A A A A A A A A A A A A A A A A J I I I I R R R R R R R R R R R R R R R R R R R R R R R R R R R R R
A A A A A A A A A A A A A A A A A A A A A A A A A A A A A A A A A A A A A A A A A A A A A A J I I I I R R R R R R R R R R R R R R R R R R R R R R R R R R R R R
A A A A A K K K K K K K K K K K K K K K K K K K K K A A K A A A K A A A K K K K A A A A A A J I I I I R R R R R R R R R R R R R R R R R R R R R R R R R R R R R
A A A A A K A A A A A A A A A A A A A A A A A A A A A A A A A A A A A A A A A A A A A A A J J I I I R R R R R R R R R R R R R R R R R R R R R R R R R R R R R R
A A A A A A A A A A A A A A A A A A A A A A A A A A A A A A A A A A A A A A A A A A A A A J J I I I R R R R R R R R R R R R R R R R R R R R R R R R R R R R R R
A A A A A K A A A A A A K K K K A A A A A K K A A A A A A A A A A A A A A A A A A A A A A J J I I I I R R R R R R S S R R R R R R R R R R R R R R R R R R R R R
A A A A A K A A A A A A K A A L L A L A A A A K A A A A A A A A A A A A A A A A A A A A J J I I I I R I R R R R R R S S R R R R R R R R R R R R R R R R R R R R
A A A A A K A A A A A A K A A A A A L L L A A K A A A A A A A A A A A A A A A A A A A A J I I I I I R I R R R R R R R S R R R R R R R R R R R R R R R R R R R R
A A A A A A A A A A A A K A L L L L L A L L A K A A A A A A A A A A A A A A A A A A A A J I I I I I I R R R R R R R R R S R R R R R R R R R R R R R R R R R R R
A A A A A A A A A A A A K A L L A A L L L A L K A A A A A A A A A A A A A A A A A A A A J I I I I I R R R R R R R R R R R R R R R R R R R R R R R R R R R R R R
A A A A A A A A A A A K A A A A A A A A L L L K A A A A A A A A A A A A A A A A A A A A J I I I I R R R R R R R R R R R R R R R R R R R R R R R R R R R R R R R
A A A A A K A A A A A A K A A A A A L L A A A A A A A A A A A A A A A A A A A A A A A A J I I I I R R R R R R R R R R R R R R R R R R D R R R R R R R R R R R R
A A A A A K A A A A A A K K K K K K J A K K K A A A A A A A A A A A A A A A A A A A A A J I I I I R R R R R R R R R R R R R R R D D D S R R R R R R R R R R R R
A A A A A K A A A A A A A A A A A A J A A A A A A A A A A A A A A A A A A A A A A A A J J I I I I R R R R R R R R R R R R R R D D R R S R R R R R R R R R R R R
A A A A A K A A A A A A A A A A A A J A A A A A A A A A A A A A A A A A A A A A A A A J J I I R R R I R R R R R R R R R R R R D R R R R S R R R R R R R R R R R
A A A A A K A A A A A A A A A A A A J A A A A A A A A A A A A A A A A A A A A A A A A J I I I R R R I R R R R R R R R R R R D D R R R R S R R R R R R R R R R R
A A EBAE A A K A A A A A A A A A A A A J A A A A A A A A A A A A A A A A A A A A A A A A J I I R R R R I R R R R R R R R R R R D R R R R R R R R R R R R R R R R R
A A EBAE A A J J J J J J J J J J J J J J J A A A A A A A A A A A A A A A A A A A A A A J J I I I R R I R R R R R R R R R R R R D R R R R R R R R R R R R R R R R R
A A A A K K A A A A A A A J J A A A J J J J A A A J J J J J A A A A A A A A A A J J J I I I I R R R R R R R R R R R R R R R D R R R R R R R R R R R R R R R R R
A A A A K K A A A A A A A A A A A A A A A A J J J A A A A A A A A A A A A A A A J I I I I I I R R R R R R R R R R R R R R R D R R R R R R R R R R R R R R R R R
A A A A A K A A A A A A A A A A A A A A A A A A A A A A A A A A A A A A A A J J J I I I I I R R R R R R R R R L R R R R R D D R R R R R R R R R R R R R R R R R
A A A A A K A A A A A A A A A A A A A A A A A A A A A A A A A A A A A A A A J I I I I I I I R R R R R R R R L R R R R R R D D R R R R O P P P P P P P Q R R R R
A A A A A K A A A A A A A A A A A A A A A A A A A A A A A A A A A A A A A J J I I I I I I I R R R R R R R R L R R R R R R D D R R R R V W W W W A A A X R R R R
A A A A A K A A A A A A A A A A A A A A A A A A A A A A A A A A A A A A J J I I I I I I I I R R R R R R R R L R R R R Y Y Y Y Y Y Y Y [ W W W W A H A X R R R R
A A A A A K A A A A A A A A A A A A A A A A A A A A A A A A A A A A A A J J I I I I I I I I R R R R R R R R L R R R R R D D D R R R R V W W W W A A A X R R R R
A A A A A K A A A A A A A A A A A A A A L L A A A A A A A A A A A A A A J J I I I I I I I I R R R R R R R R R R R R R R D D D R R R R V W W W W W W W X R R R R
A A A A A K A A A A A A A A A A A A A A A L L A A A A A A A A A A A A A J J I I I I I I R R R R R R R R R R R R R R R R D D D R R R R ] ^ ^ ^ ^ ^ ^ ^ _ R R R R
A A A A A K A A A A A A A A A A A A A A A A A A A A A A A A A A A A A A J J I I I I I R R R R R R R R R R R R R R R R R D D D R R R R R R R R R R R R R R R R R
A A A A A K A A A A A A A A A A A A A A A A A A A A A A A A A A A A A A J I I I I I R R R R R R R R I I R R R R R R R R D D D R R R R R R R R R R R R R R R R R
A A A A A K A A A A A A A A A A A A A A A A A A A A A A A A A A A A A A J I I I I R R R R R R R I I R R R R R R R R D D D R R S R R R R R R R S S R R R R R R R
A A A A A K A A A A A A A A A A A A A A A A A A A A A A A A A A A A A A J I I I R R R R R R R I R R R R R R R R R D D R R S S R R R R R R R R R R R R R R R R R
A A A A A K A A A A A A A A A A A A A A A A A A A A A A A A A A A A A A J I I R R R R R R R R R R R R R R R R R R R R R S S R R R R R R R R R R R R R R R R R R
A A A A A K A A A A A A A A A A A A A A A A A A A A A A A K K K A A K A K K I R R I R R R R R R R R R R R R R R R R R S S R R R R R R R R R R R R R R R R R R R
A A A A A A A A A A A A A A A A A A A A A A A A A A A A A K A A A A A A J K I R R I R R R R R R R R R R R R R R R R S R R R R R R R R R R R R R R R R R R R R R
A A EBAE A A J J J J J J J J J J J J A J J J J J J J J J A A A L L A L L L J L I R R I R R R R R R R R R R R R R R R S R R R R R R R R R R R R R R R R R R R R R R
A A EBAE A A A J J J J J J J J J A A A A J A A J J J J J J J A L A L L A L J I I R R R I R R R R R R R R R R R R R R R R R R R R R R R R R R R R R R R R R R R R R
A A A A A K J A A A A A A A A A A A A A A A A A A A A A A A L A L L L A J I I R R R R R R R R R R R R R R R R R R R R R R R R R R R R R R R R R R R R R R R R R
A A A A A J J J A A A A A A A A A A A A A A A A A A A A A K L A L L L L L I I R R R R R R R R R R R R R R R R R R R R R R R R O P P P P P P P P Q R R R R R R R
A A A A A A A A A A A A A A A K A J A A A A A A A A A A A K L L L L L L L L I R R R R R R R R R R R R R R R R R R R R R R R R V W W W W W W W W X R R R R R R R
A A A A A A A A A A A A A A K A A A J A A A K A A A A A A K A L L L L L J I I I R R R R R R R R R R R R R R R R R R R R R R R V W W W W W W W W X R R R R R R R
A A A A A K A A A A A A A A A L L L L A A A K K K A A A A K A A A A L L J I I I R R R R R R R R R R R R R R R R R R R R R R R V W W W W W W W W X R R R R R R R
A A A A A K A A A A A L L L L L L L L L A A A A K A A A A K K K K K K A K K I I R R R R R R R R R R R R R R R R R R R R R R R V W W W W W W W W X R R R R R R R
A A A A A K A A A A A L L L L L L L L L L L L A K A A A A A A A A A A A J I I R R S S R R R R R R R R R R R R R R R R R R R R [ W W S S W W W W X R R R R R R R
A A A A A K A A A A A L L L L L L L L L A A A A K A A A A A A A A A A A J I I R R R S S R R R R R R R R R R R R R R R R R R R V W W W W W W W W X R R R R R R R
A A A A A K A A K A L L L L L L L A L L L L L A K A A A A A A A A A A A J I I I I I I I S R R R R R R R R S R R R R R R R R R V W W W W W W W W X R R R R R R R
A A A B A K A A K A L L A L L L L L L L L L L A K A A A A A A A A A A A J I I I I I I I I R R R R R R R R R S R R R R R R R R ] ^ ^ ^ ^ ^ ^ ^ ^ _ R R R R R R R
A A B B A K A A K A A L L L L L L L L L L L L A K A A A A A A A A A A A J I I I I I I I I I R R R R R R R R R S R R R R R R R R R R R R R R R R R R R R R R R R
A A B B A K A A K K A A A A A A A A A A A A A A K A A A A A A A A A A A A J J I I I I I I I I R R R R R R R R R S R R R R R R R R R R R S R R R R R R R R R R R
A A B B A K A A A A A A A A A K K K K K K K K K K A A A A A A A A A A A A A J J I I I I I R I R R R R R R R R R R S R S R R R R R R R R R R R R R R R R R R R R
A A B B A K A A A A A A A A A A A A A A A A A A A A A A A A A A A A A A A A J J I I I I I R R R R R I R R R R R R R R R S S R R R R R R R R R R R R R R R R R R
A A B B A K A A A A A A K K K A A A A A A A A A A A A A A A A A A A A A A A A A I I I I I R R R R R R R I R R R R R R R R R R R R R R R R R R R R R R R R R R R
A A A A A K A A A A A A A A K K A A A A A A A A A A A A A A A A A A A A A A A A A A I I I R R R R R R R R I I R R R R R R R R R R R R R R R R R R R R R R R R R
A A A A A K A A A A A A A A A A A A A A A A A A A A A A A A A A A A A A A A A A A A A I I R R R R R R R R R I I I R R R R R R R R R R R R R R R R R R R R R R R
A A A A A K A K K K K K K K K A A A K K K K K K K A A K K A A A A A A A A A A A A A A J J R R R R R R R R R R R I R R R R R R R R R R R R R R R R R R R R R R R
A A A A A A A A A A A A A A A A A A A A A A A A A A A A A A A A A A A A A A A A A A A J J J R R R R R R R R R R R R R R R R R R R R R R R R R R R R R R R R R R
A A A A A A A A A A A A A A A A A A A A A A A A A A A A A A A A A A A A A A A A A A A J J J I I R R R R R R R R R R R R R R R R R R R R R R R R R R R R R R R R
A A A A A A A A A A A A A A A A A A A A A A A A A A A A A A A A A A A A A A A A A A A J J J J I R R R R R R R R R R R R R R R R R R R R R R R R R R R R R R R R
A A A A A A A A A A A A A A A A A A A A A A A A A A A A A A A A A A A A A A A A A A A A J J J I I R R R R R R R R R R R R R R R R R R R R R R R R R R R R R R R
A A A A A A A A A A A A A A A A A A A A A A A A A A A A A A A A A A A A A A A A A A A A A A J I I I R R R R R R R R R R R R R R R R R R R R R R R R R R R R R R
A A A A A A A A A A A A A A A A A A A A A A A A A A A A A A A A A A A A A A A A A A A A A A J I I I I R R R R R R R R R R R R R R R R R R R R R R R R R R R R R