U U U U U U U U U U U U U U U U U U U U U U U U U T T T T T
U T T T T T T T T T T T T T T T T T T T T T T T U T T T T T
U T T T T T T T T T T T T T T T T T T T T T T T T T T T T T
U T T T T T T T T T T T T T T T T T T T T T T T T T T T T T
U T T T T T T T T T T T T T T T T T T T T T T T U T T T T T
U T T T T T T T T T T T T T T T T T T T T T T T U T T T T T
U T T T T T T T T T T T T T T T T T T T T T T T U T T T T T
U T T T U U U U U U U U U T T T T T T T T T T T U T T T T T
U T T T T T T T T T T ` U T T T T T T T T T T T U T T T T T
U T T T T T T T T T T T U U U U U U U U U U U U U T T T T T
U T T T T T U U U U U U T T T T T T T T T T T T U T T T T T
U T T T T T T T T T T T T T T T T T T T T T T T U T T T T T
U T T T T T T T T T T T T T T T T T T T T T T T U T T T T T
U T T T T T T T T T T T T T T T T T T T T T T T U T T T T T
U T T T T T T T T T T T T T T T T T T T T T T T U T T T T T
U T T T T T T T T T T T T T T T T T T T T T T T U T T T T T
U T T T T T T T T T T T T T T T T T T T T T T T U T T T T T
U T T T T T T T T T T T T T T T T T T T T T T T U T T T T T
U T T T T T T T T T T T T T T T T T T T T T T T U T T T T T
U T T T T T T T T T T T T T T T T T T T T T T T U T T T T T
U T T T T T T T T T T T T T T T T T T T T T T T U T T T T T
U U U U U U U U U U U U U U U U U U U T T T T T U T T T T T
U T T T T T T T T T T T T T T T T T T T T T T T U T T T T T
U T T T T T T T T T T T T T T T T T T T T T T T U T T T T T
U T T T T T T T T T T T T T T T T T T T T T T T U T T T T T
U T T T T T T T T T T T T T T T T T T T T T T T U T T T T T
U T T T T T T T T T T T T T T T T T T T T T T T U T T T T T
U T T T T T T T T T T T T T T T T T T T T T T T U T T T T T
U T T T a T T a T T T T T T T T T T T T T T T T U T T T T T
U U U U a T T a U U U U U U U U U U U U U U U U U T T T T T
U T T T T T T T T U T T T T T T T T T T T T T T T T T T T T
U T T T T T T T T U T T T T T T T T T T T T T T T T T T T T
U T T T T T T T T U T T T T T T T T T T T T T T T T T T T T
U T T T T T T T T U T T T T T T T T T T T T T T T T T T T T
U T T T T T T T T U T T T T T T T T T T T T T T T T T T T T
U T \BFEAAB T T T T T T U T T T T T T T T T T T T T T T T T T T T
U T T T T T T T T U T T T T T T T T T T T T T T T T T T T T
U T T T T T T T T U T T T \BHEAAC T T T T T T T T T T T T T T T T
U T T T T T T T T U T T T T T T T T T T T T T T T T T T T T
U T T T T T T T T U T T T T T T T T T T T T T T T T T T T T
U U U U U U U U U U T T T T T T T T T T T T T T T T T T T T
T T T T T T T T T T T T T T T T T T T T T T T T T T T T T T