A A A A A A A A A A A A A A A A A A A A A A A A A A A A A A A A A A A A A A A A A A A A A A A A A A A A A A A A A A A D D A A A A A A A A A A A A A A A A A A A
A A A A A A A A A A A A A A A A A A A A A A A A A A A A A A A A A A A A A A A A A A A A A A A A A A A A A A A A A A A D D A A A A A A A A A A A A A A A A A A A
A A A A A A A K K K K K K K K K K K K K K K K K K K K K K K K K K K K K K K K K K K K K K K K K K K K K K K K K K K K K K K K K K K K K K K K K K K K K K K K A
A A A A A A A K H A K A A A A A A A A A A A A A A A A A A A A A A A A A A A A A A A A A A A A A A A A A A A A A A I D D A A A A A A A A A A A A A A A K A H K A
B B B A A A A K A A K A A A A A A A A A A A A A A A A A A A A A A A A A A A A A A A A A A A A A A A A A A A A A A I I D A A A A A A A A A A A A A A A K A A K A
B B B A A A A K K K K A A A A A A A A A A A A A A A A A A A A A A A A A A A A A A A A A A A A A A A B B B B A A A I D D A A A A A A A A A A A A A A A K K K K A
B B B B A A A K A A A A K K K K K L K K K K K K K K K A A A A A A A A A A A A A A A A A A A A A A A B B B B A A A D D A A A A A A A A A A A A A A A A A A A K A
B B B B B A A K A A A A K L L L L L L L L L L L L L K A A A A A A A A A A A A A A A A A A A A A A B B B B B A A A D D A A A A A A A A K K K K K K L K K K K K A
A B B B B B A K A A A A K L L L L L L L L L L L L L K A A A A A A A A A A A A A A A A A A A A B B B B B A A A A A D I A A A A A A A A K L L L L L L L L L L K A
A A B B B B B K A A A A K K K K K K K L L L L L L L K A A A A A A A A A A A A A A A A A B B B B B B B B A A A A A D D A A A A A A A A K L L L L L L L L L L K A
A A A B B B B K A A A A K L L L L L L L L L L L L L K A A A A A A A A A A A A A A A A B B B B B B B B A A A A A A D D A A A A A A A A K L L L L L L L L L L K A
A A A B B B B K A A A A K L L L L L L L L L L L L L K A A A A A A B B B B B B B B B B B B B B B B A A A A A A A A D D A A A A A A A A K L L L L L L L L L L K A
A A A A B B B K A A A A K L L L L L L L L L L L L L K A A A A A A B B B B B B B B B B B B B A A A A A A A A A A A D D A A A A A A A A K L L L L L L L L L L K A
A A A A B B B K A A A A K L L L L K K K K K K K K K K A A A A A A B B B B B B B B B B B A A A A A A A A A A A A A D D A A A A A A A A K L L L L L L L L L L K A
A A A B B B B K A A A A K L L L L L L L L L L L L L K A A A A A A A A A A B B B B B B A A A A A A A A A A A A A A D D A A A A A A A A K L L L L L L L L L L K A
A A A B B B B K A A A A K L L L L L L L L L L L L L K A A A A A A A A A B B B B B B B A A A A A A A A A A A A A A D D A A A A A A A A K K K K K K L K K K K K A
A A B B B B A K A A A A K L L L L M L L L L L L L L K A A A A A A A A A B B B B B A A A A A A A A A A A A A A A A D A A A A A A A A A K L L L L L L L L L L K A
A A B B B B A K A A A A K K K J K K K K K K K K K K K A A A A A A A A A B B B B A A A A A A A A A A A A A A A A A D A A A A A A A A A K L L L L L L L L L L K A
A B B B B B A K A A A A A A A J J A A A A A A A A A A A A A A A A A A A A A A A A A A A A A A A A A A A A A A A A D A A A A A A A A A K L L L L L L L L L L K A
A B B B B A A K A A A A A A A A J A A A A A A A A A A A A A A A A A A A A A A A A A A A A A A A A A A A A A A A A D A A A A A A A A A K L L L L L L L L L L K A
A B B B A A A K A A A A A A A A J A A A A A A A A A A A A A A A A A A A A A A A A A A A A A A A J J J J J J J J G F G J J J J J J J A K L L L L L L L L L L K A
A A A A A A A K A A A A A A A A J A A A A A A A A A A A A A A A A A A A A A A A A A A A A A A J J J J A A A A A A D D A A A A A A J A K L L L L L L L L L L K A
A A A A A A A K A A A A A A A A J A A A A A A A A A A A A A A A A A A A A A A A A A A A A A A J J A A A A A A A A D D A A A A A A J A K L L L L L L L L L L K A
A A A A A A A K A A A A A A A A J A A A A A A A A A A A A A A A A A A A A A A A A A A A A J J J A A A A A A A A A I D A A A A A A J A K L L L L L L L L L L K A
A A A A A A A K A A A A A A A A J A A A A A A A A A A A A A A A A A A A A A A A A A A J J J J J A A A A A A A A A I D A A A A A A J A K L L L L L L L L L L K A
A A A A A A A K A A A A A A A A J A A A A A A A A A A A A A A A A A A A A A A A A A J J J J A A A A A A A A A A A D D A A A A A A J A K L L L L L L L L L L K A
A A A A A A A A A A A A A A A A J A A A A A A A A A A A A A A A A A A A A A A A A A J J A A A A A A A A A A A A A D A A A A A A A J A K L K K K L L L L L L K A
A A A A EBAE J J J J J J J J J J J J J J J J J J J J J J J J J J J J J J J J J J J J J J J A A A A A A A A A A A A A D A A A A A A A J A K K L L L L L L K K K K A
A A A A EBAE J J J J J J J J J J J J J J J J J J J J J J J J J J J J J J J J J J J J J J J A A A A A A A A A A A A A D A A A A A A A J A K L L L L L L L K L L K A
A A A A A A A A A A A A J A A A A A A A A A A A A A A A A A A J J A A A A A A A A A A A A A A A A A A A A A A A D D A A A A A A A J A K L L L L L L L K L L K A
A A A A A A A K A A A A J A A A A A A A A A A A A A A A A A A A J A A A A A A A A A A A A A A A A A A A A A A A D I A A A A A A A J A K L L L L L L L K L M K A
A A A A A A A K A A A A J A A A A A A A A A A A A A A A A A A A J A A A A A A A A A A A A A A A A A A A A A A D D I A A A A A A A J A K L L L L L L L K L L K A
A A A A A A A K A A A A J A A A A A A A A A A A A A A A A K K K J J K K K K K K K K K K K K A A A A A A A A A D D I A A A A A A A J A K L L L L L L L K K K K A
A A A A A A A K A A A A J A A A A A A A A A A A A A A A A K L L L J L L L L L L L L L L L K A A A A A A A A A D D A A A A A A A A J A K L L L L L L L L L L K A
A A A A A A A K A A A A J A A A A A A A A A A A A A A A A K L L L L L L L L K L L L L L L K A A A A A A A A A D D A A A A A A A A J A K L L L L L L L L L L K A
A A A A A A A K A K K K J K K K K K K K K A A A A A A A A K L L L L L L L L K K L M L L L K A A A A A A A A A D D A A A A A A A A J A K L L L L L L L L L L K A
A A A A A A A K A K L L J L M M L L L L K A A A A A A A A K L L L L L L L L L K L L L L L K A B B B B A A A A D D A A A A A A A A J A K L L L L L L L L L L K A
A A A A A A A K A K L L L L L L L L L L K A A A A A A A A K L L L L K L L L L L K K K K L K A B B B B A A A D D D A A A A A A A A J A K K K K K K L L K K K K A
A A A A A A A K A K K K K K K K L L L L K A A A A A A A A L L L L L K L L L L L L L L L L K A B B B B A A A D D A A A A A A A A A J A K L L L L L L L L L L K A
A A A A A A A K A K L L L L L L L L L L K A A A A A A A A K L L L L K L L L L L L L L L L K A A B B B A A D D D A A A A A A A A A J A K L L L L L L L L L L K A
A A A A A A A K A K L L L L L L L L L L K A A A A A A A A K K K K K K L L L L L L L L L L K A A B B B A A D D D A A A A A A A A A J A K L L L L L L L L L L K A
A A A A A A A K A K L L L L L L L L L L K A A A A A A A A K L L L L L L L L L L L L L L L K A A B B B A A D D A A A A A A A A A A J A K L L L L L L L L L L K A
A A A A A A A K A K L L L L K L L L L L K A A B B B A A A K L L L L L L L L L L L L L L L K A A B B B A A D D A A A A A A A A A A J A K L L L L L L L L L L K A
A A A A A A A K A K L L L L K L L L L L K A A B B B A A A K L L L L L L L L L L L L L L L K A A B B B A A D A A A A A A A A A A A J A K L L L L L L L L L L K A
A A A A A A A K A K L L L L K L L L L L K A A B B B B A A K L L L L L L K K K K K K K K K K A A B B B A I D A A A A A A A A A A A J A K L L L L L L L L L L K A
A A A A A A A K A K L L L L K L L L L L K A A B B B B A A K L L L L L L K M L L L L L L L K A A A A A A I D A A A A A A A A A A A J A K L L L L L L L L L L K A
A A A A A A A K A K L L L L K L L L L L K A A B B B B A A K L L L L L L L L L L L L L L L L A A A A A A D D A A A A A A A A A A A J A K L L K K K L L L L L K A
A A A A A A A K A K L L L L K L L L L L K A A A B B B A A K L L L L L L L L L L L L L L L K A A A A A D D D A A A A A A A A A A A J A K L L L L K K K K K K K A
A A A A A A A K A K L L L L K L L L L L K A A A B B B B A K K K K K K K K K K K K K K K K K A A A A A D D A A A A A A A A A A A A J A K L L L L L L L L L L K A
A A A A A A A K A K K K L K K K K K K K K A A A B B B B B A A A A A A A A A A A A A A A A A A A A A A D A A A A A A A A A A A A A J J L L L L L L L L L L L K A
A A A A A A A K A A A A A A A A A A A A A A A A A B B B B B A A A A A A A A A A A A A A A A A A A A D D A A A A A A A A A A A A A A A K L L L L L L L L L L K A
A A A A A A A K A A A A A A A A A A A A A A A A A B B B B B B B B B B A A A A A A A A A A A A A A D D D A A A A A A A A A A A A A A A K L L L L L L L L L L K A
A A A A A A A K K K K A A A A A A A A A A A A A A A A B B B B B B B B A A A A A A A A A A A A A A D D A A A A A A A A A A A A A A A A K L L L L L L L K K K K A
A A B B B A A K A A K A A A A A A A A A A A A A A A A B B B B B B B B A A A A A A A A A A A A A A D D A A A A A A A A A A A A A A A A K L L L L L L L K A A K A
A A B B B B A K H A K A A A A A A A A A A A A A A A A A A A A A A A A A A A A A A A A A A A A A D D D A A A A A A A A A A A A A A A A K L L L L L L L K A H K A
A A B B B B A K K K K K K K K K K K K K K K K K K K K K K K K K K K K K K K K K K K K K K K K K K K K K K K K K K K K K K K K K K K K K K K K K K K K K K K K A
A A B B B B B B A A A A A A A A A A A A A A A A A A A A A A A A A A A A A A A A A A A A A A A D D D D A A A A A A A A A A A A A A A A A A A A A A A A A A A A A
A A A B B B B B B B B B B B B B B A A A A A A A A A A A A A A A A A A A A A A A A A A A A A A D D A A A A A A A A A A A B B B A A A A A A A A A A A A A A A A A
A A A A B B B B B B B B B B B B B A A A A A A A A A A A A A A B B B B B B A A A A A A A A A D D A A A A A A A A A A B B B B B A A A A A A A A A A A A A A A A A
A A A A A B B B B B B B B B B B B A A A A A A A A A A A A A A B B B B B B B B B B B B B B B A A A A A A A A A A A B B B B B B A A A A A A A A A A A A A A A A A