a a a a a a a a a a a a a a a a a a a a a a a a a a i i i i i i i i i a a a a a a a a
a a a a a a a a a a a a a i i i i i i i i i a a a i i i i i i i i i i a a a a a a a a
a a a a a a a a a a a a a i i i i i i i i i i i i i i i i i i i i i i a a a a a a a a
a a a a a a a a a a a a a i i i i i i i i i i i i i i i i i i i i i i a a a a a a a a
a a a a a a a a a a a i i i i i i i i i i i i i i i i i i i i i i i i a a a a a a a a
a a a a a a a a a a i i i i i i i i i i i i i i i i i i i i i i i i i d d d d d d a a
a a a a a a a a a i i i i i i i i i i i i i i i i i i i i i i i i i i d d d d d d d d
a a a a a a a a i i i i i i i i i i i i i i i i i i i i i i i i i i i d d d d d d d d
a a a a a a a a i i i i i i i i i i i i i i i i i i i i i i i i i d d d d d d d d d d
a a a a a a a a i i i i i i i i i i i i i i i i i i i i i i i i d d d d d d d d d d d
a a a a a a a a i i i i i i i i i i i i i i i i i i i i i i f f f f f f f f f f f f f
a a a a a a a a i i i i i i i i i i i i i i i i i i i i i i d d d d d d d d d d d d d
a a a a a a a a i i i i i i i i i i i i i i i i i i i i i d d d d d d d d d d d d d d
a a a a a a a a i i i i i i i i i i i i i i i i i i i i b b b b b c c d d d d d d d d
a a a a a a i i i i i i i i i i i i i i i i i i i i i b b b b b b c c c c c c c d d d
a a a a i i i i i i i i i i i i i i i i i i i i i b b b b b b b b c c c c c c c c b b
a a i i i i i i i i i i i i i i i i i i i i b b b b b b b b b b b c c c c c c c c b b
a i i i i i i i i i i i i i i i i i i i i b b b b b b b b b b b b c c c c c c c c c b
a i i i i i i i i i i i i i i i i i i b b b b b b b b b b b b c c c c c c c c c c c b
a i i i i i i i i i i i i i i i i i i b b b b b b b b b b b c c c c c c c c c c c c b
a i i i i i i i i i i i i i i i i i i b b b b b b b b b b b c c c c c c c c c c c c c
a i i i i i i i i i i i i i i i i b b b b b b b b b b b b b c c c c c c c c c c c c c
c c c i i i i i i i i i i i i i b b b b b b b b b b b b b b c c c c c c c c c c c c c
c c c c i i i i i i i i i i b b b b b b b b b b b b b b b b c c c c c c c c c c c c c
c c c c c i i i i i i i b b b b b b b b b b b b b b b b b b c c c c c c c c c c c c c
c c c c c c c i i i a a b b b b b b b b b b b b b b b b b c c c c c c c c c c c c c c
c c c c c c c c a a a a b b b b b b b b b b b b b b b b b c c c c c c c c c c c c c c
a c c c c c c c c a a a b b b b b b b b b b b b b b b a a c c c c c c c c c c c c c c
a a a a a c c c c c a a b b b b b b b b b b b b b b b a a c c c c c c c c c c c c c a
a a a a a a a a c c c a a b b b b b b b b b b b b b b a a c c c c c c c c c c c c b a
a a a a a a a a a c c c c a a b b b b b b b b b a a a a a c c c c c c c c c c b b b a
a a a a a a a a a c c c c c a b b b b b b b b a a a a a a c c c c c c c c c a a a a a
a a a a a a a a a a a c c c a a a a a a a a a a a a a a c c c c c c c c c c a a a a a
a a a a a a a a a a a a a a a a a a a a a a a a a c c c c c c c c c c c c c a a a a a
a a a a a a a a a a a a a a a a a a a a a a a c c c c c c c c c c c c c c c a a a a a
a a a a a a a a a a a a a a a a a a a a a c c c c c c c c c c c c c c c c c a a a a a
a a a a a a a a a a a a a a a a a a a c c c c c c c c c c c c c c c c c c c a a a a a
a a a a a a a a a a a a a a a a a a a c c c c c c c c c c c c c c c c c c c a a a a d
a a a a a a a a a a a a a a a a a a a c c c c c c c c c c c c c c c c c c a a a a a d
a a a a a a a a a a a a a a a a a a a c c c c c c c c c c c c c c c c c a a a a a a d
a a a a a a a a a a a a a a a a a a a c c c c c c c c c c c c c c c c a a a a a a a d
a a a a a a a a a a a a a a a a a a a c c c c c c c c c c c c c c c c a a a a a a a d
a a a a a a a a a a a a a a a a a a a c c c c c c c c c c c c c c c c a a a a a a a d
a a a a a a a a a a a a a a a a a a a c c c c c c c c c c c c c c c c a a a a a a a d
a a a a a a a a a a a a a a a a a a a a a a a a a a a a a a a a a a a a a a a a a a d
a a a a a a a a a a a a a a a a a a a a a a a a a a a a a a a a a a a a a a a a a a d
a a a a a a a a a a a a a a a a a a a a a a a a a a a a a a a a a a a a a a a a a a a
a a a a a a a a a a a a a a a a a a a a a a a a a a a a a a a a a a a a a a a a a a a
a a a a a a a a a a a a a a a a a a a a a a a a a a a a a a a a a a a a a a a a a a a
a a a a a a a a a a a a a a a a a a a a a a a a a a a a a a a a a a a a a a a a a a a