AAA BAA CAA DAA EAA FAA GAA HAA IAA JAA KAA LAA MAA AAA AAA AAA AAA AAA AAA AAA AAA AAA AAA AAA AAA AAA AAA AAA AAA AAA AAA AAA AAA AAA AAA AAA AAA AAA AAA AAA AAA AAA AAA AAA AAA AAA AAA AAA AAA AAA AAA AAA AAA AAA AAA AAA AAA AAA AAA AAA AAA AAA AAA AAA AAA AAA AAA AAA AAA AAA AAA AAA AAA AAA AAA AAA AAA AAA AAA AAA AAA AAA AAA AAA AAA AAA AAA AAA AAA AAA
AAA AAA AAA AAA AAA AAA AAA AAA AAA AAA AAA AAA AAA AAA AAA AAA AAA AAA AAA AAA AAA AAA AAA AAA AAA AAA AAA AAA AAA AAA AAA AAA AAA AAA AAA AAA AAA AAA AAA AAA AAA AAA AAA AAA AAA AAA AAA AAA AAA AAA AAA AAA AAA AAA AAA AAA AAA AAA AAA AAA DAA DAA DAA DAA DAA DAA DAA DAA AAA AAA AAA AAA AAA AAA AAA AAA AAA AAA AAA AAA AAA AAA AAA AAA AAA AAA AAA AAA AAA AAA
AAA AAA AAA AAA AAA AAA AAA AAA AAA AAA AAA AAA AAA AAA AAA AAA AAA AAA AAA AAA AAA AAA AAA AAA AAA AAA AAA AAA AAA AAA AAA AAA AAA AAA AAA AAA AAA AAA AAA AAA AAA AAA AAA AAA AAA AAA AAA AAA AAA AAA DAA DAA DAA DAA DAA DAA DAA DAA DAA DAA DAA DAA DAA DAA DAA DAA DAA DAA AAA AAA AAA AAA AAA AAA AAA AAA AAA AAA AAA AAA AAA AAA AAA AAA AAA AAA AAA AAA AAA AAA
AAA AAA AAA AAA AAA AAA AAA AAA AAA AAA AAA AAA AAA AAA AAA AAA AAA AAA AAA AAA AAA AAA AAA AAA AAA AAA AAA AAA AAA AAA AAA AAA AAA AAA AAA AAA AAA AAA AAA AAA DAA DAA DAA DAA DAA DAA DAA DAA DAA DAA DAA DAA DAA DAA DAA DAA DAA DAA DAA DAA DAA DAA DAA DAA DAA DAA DAA DAA DAA AAA AAA AAA AAA AAA AAA AAA AAA AAA AAA AAA AAA AAA AAA AAA AAA AAA AAA AAA AAA AAA
AAA AAA AAA AAA AAA AAA AAA AAA AAA AAA AAA AAA AAA AAA AAA AAA AAA AAA AAA AAA AAA AAA AAA AAA AAA AAA AAA AAA AAA AAA AAA AAA AAA AAA AAA AAA AAA AAA AAA AAA AAA AAA AAA AAA AAA AAA AAA AAA AAA AAA AAA AAA AAA AAA AAA AAA AAA AAA AAA AAA AAA AAA AAA AAA AAA AAA DAA DAA DAA AAA AAA AAA AAA AAA AAA AAA AAA AAA AAA AAA AAA AAA AAA AAA AAA AAA AAA AAA AAA AAA
AAA AAA AAA AAA AAA KAA KAA KAA KAA KAA KAA KAA KAA KAA KAA KAA KAA KAA KAA KAA KAA KAA KAA KAA KAA KAA KAA KAA KAA KAA KAA KAA AAA AAA AAA AAA AAA AAA AAA AAA AAA AAA AAA AAA AAA AAA AAA AAA AAA AAA AAA AAA AAA AAA AAA AAA AAA AAA AAA AAA AAA AAA AAA AAA AAA AAA AAA AAA DAA DAA AAA AAA AAA AAA AAA AAA AAA JAA JAA JAA JAA JAA JAA JAA JAA JAA AAA AAA AAA AAA
AAA AAA AAA AAA AAA KAA LAA LAA LAA LAA LAA LAA LAA LAA LAA LAA LAA LAA LAA LAA LAA LAA LAA KAA KAA LAA LAA LAA LAA LAA LAA KAA AAA AAA AAA AAA AAA AAA AAA AAA AAA AAA AAA AAA AAA AAA AAA AAA AAA AAA AAA AAA AAA AAA AAA AAA AAA AAA AAA AAA AAA AAA AAA AAA AAA AAA AAA AAA AAA DAA AAA AAA AAA AAA AAA AAA JAA JAA JAA JAA JAA JAA JAA JAA JAA JAA JAA AAA AAA AAA
AAA AAA AAA AAA AAA KAA LAA LAA LAA LAA LAA LAA LAA LAA LAA LAA LAA LAA LAA LAA LAA LAA LAA LAA KAA LAA LAA MAA MAA LAA LAA KAA AAA AAA AAA AAA AAA AAA AAA AAA KAA KAA KAA KAA KAA KAA KAA KAA KAA KAA KAA KAA KAA KAA KAA KAA KAA KAA KAA KAA KAA KAA KAA KAA KAA AAA AAA AAA AAA DAA DAA AAA AAA AAA AAA AAA JAA JAA LAA LAA LAA LAA LAA LAA LAA JAA JAA AAA AAA AAA
AAA AAA AAA AAA AAA KAA LAA LAA LAA LAA LAA LAA LAA LAA LAA LAA LAA LAA LAA LAA LAA LAA LAA LAA KAA LAA LAA LAA LAA LAA LAA KAA AAA AAA AAA AAA AAA AAA AAA AAA KAA LAA LAA LAA LAA LAA LAA LAA KAA LAA LAA LAA LAA LAA LAA LAA LAA KAA LAA LAA LAA LAA LAA LAA KAA AAA AAA AAA AAA AAA DAA AAA AAA AAA AAA AAA JAA JAA LAA DAA DAA DAA LAA LAA LAA JAA JAA AAA AAA AAA
AAA AAA AAA AAA AAA KAA LAA LAA LAA LAA LAA LAA LAA LAA LAA LAA LAA LAA LAA LAA LAA LAA LAA LAA LAA LAA LAA LAA LAA LAA LAA KAA AAA AAA AAA AAA AAA AAA AAA AAA KAA LAA LAA LAA LAA LAA LAA LAA LAA LAA LAA LAA LAA LAA LAA LAA LAA KAA LAA LAA LAA LAA LAA LAA KAA AAA AAA AAA AAA AAA DAA AAA AAA AAA AAA AAA JAA JAA LAA DAA DAA DAA DAA DAA LAA JAA JAA AAA AAA AAA
AAA AAA AAA AAA AAA KAA KAA KAA KAA KAA KAA KAA KAA KAA KAA KAA LAA LAA LAA LAA LAA LAA LAA LAA LAA LAA LAA LAA LAA LAA LAA KAA AAA AAA AAA AAA AAA AAA AAA AAA KAA LAA LAA LAA LAA LAA LAA LAA LAA LAA LAA LAA LAA LAA LAA LAA LAA KAA LAA LAA LAA LAA LAA LAA KAA AAA AAA AAA AAA AAA FAA AAA AAA AAA AAA AAA JAA JAA LAA DAA DAA DAA DAA DAA LAA JAA JAA AAA AAA AAA
AAA AAA AAA AAA AAA KAA LAA LAA LAA LAA LAA LAA LAA LAA LAA LAA LAA LAA LAA LAA LAA LAA LAA LAA KAA LAA LAA LAA LAA LAA LAA KAA AAA AAA AAA AAA AAA AAA AAA AAA KAA LAA LAA LAA LAA LAA LAA LAA KAA LAA LAA LAA LAA LAA LAA LAA LAA KAA LAA LAA MAA LAA LAA LAA KAA AAA AAA AAA AAA AAA DAA AAA AAA AAA AAA AAA JAA JAA LAA DAA DAA DAA DAA DAA LAA JAA JAA AAA AAA AAA
AAA AAA AAA AAA AAA KAA LAA LAA LAA LAA LAA LAA LAA LAA LAA LAA LAA LAA LAA LAA LAA LAA LAA LAA KAA LAA LAA LAA LAA LAA LAA KAA AAA AAA AAA AAA AAA AAA AAA AAA KAA LAA LAA LAA LAA LAA LAA LAA KAA LAA LAA LAA LAA LAA LAA LAA LAA KAA LAA LAA LAA LAA LAA LAA KAA AAA AAA AAA AAA AAA DAA AAA AAA AAA AAA AAA JAA JAA LAA FAA FAA FAA FAA FAA LAA JAA JAA AAA AAA AAA
AAA AAA AAA AAA AAA KAA LAA LAA LAA LAA LAA LAA LAA LAA LAA LAA LAA LAA LAA LAA LAA LAA LAA LAA KAA LAA LAA LAA LAA LAA LAA KAA AAA AAA AAA AAA AAA AAA AAA KAA KAA LAA LAA LAA LAA LAA LAA LAA KAA LAA LAA LAA LAA LAA LAA LAA LAA KAA LAA LAA LAA LAA LAA LAA KAA AAA AAA AAA AAA AAA DAA AAA AAA AAA AAA AAA JAA JAA LAA DAA DAA DAA DAA DAA LAA JAA JAA AAA AAA AAA
AAA AAA AAA AAA AAA KAA LAA LAA LAA LAA LAA LAA LAA LAA LAA LAA LAA LAA LAA LAA LAA LAA LAA LAA KAA LAA LAA LAA LAA LAA LAA KAA AAA AAA AAA AAA AAA AAA AAA KAA LAA LAA LAA LAA LAA LAA LAA LAA KAA LAA LAA LAA LAA LAA LAA LAA LAA KAA LAA LAA LAA LAA LAA LAA KAA AAA AAA AAA AAA AAA DAA AAA AAA AAA AAA AAA JAA JAA LAA DAA DAA DAA DAA DAA LAA JAA JAA AAA AAA AAA
AAA AAA AAA AAA AAA KAA LAA LAA LAA LAA LAA LAA LAA LAA LAA LAA LAA LAA LAA LAA LAA LAA LAA LAA KAA LAA LAA LAA LAA LAA LAA KAA AAA AAA AAA AAA AAA AAA AAA KAA LAA LAA LAA LAA LAA LAA LAA LAA KAA LAA LAA LAA LAA LAA LAA LAA LAA KAA LAA LAA LAA LAA LAA LAA KAA AAA AAA AAA AAA AAA DAA AAA AAA AAA AAA AAA JAA JAA LAA LAA DAA DAA DAA LAA LAA JAA JAA AAA AAA AAA
AAA AAA AAA AAA AAA KAA LAA LAA LAA LAA LAA LAA LAA LAA LAA LAA LAA LAA LAA LAA LAA LAA LAA LAA KAA LAA LAA LAA LAA LAA LAA KAA AAA AAA AAA AAA AAA AAA AAA KAA LAA LAA LAA MAA LAA LAA LAA LAA KAA LAA LAA LAA LAA LAA LAA LAA LAA KAA LAA LAA LAA LAA LAA LAA KAA AAA AAA AAA AAA AAA DAA AAA AAA AAA AAA AAA JAA JAA LAA LAA LAA LAA LAA LAA JAA JAA JAA AAA AAA AAA
AAA AAA AAA AAA AAA KAA LAA LAA LAA LAA LAA LAA LAA LAA LAA LAA LAA LAA LAA LAA LAA LAA KAA KAA KAA KAA KAA KAA KAA KAA KAA KAA AAA AAA AAA AAA AAA AAA AAA KAA LAA LAA LAA LAA LAA LAA LAA LAA KAA LAA LAA LAA LAA LAA LAA LAA LAA KAA LAA LAA LAA LAA LAA LAA KAA AAA AAA AAA AAA AAA DAA AAA AAA AAA AAA AAA JAA JAA JAA LAA LAA LAA LAA LAA JAA JAA AAA AAA AAA AAA
AAA AAA AAA AAA AAA KAA LAA LAA LAA LAA LAA LAA LAA LAA LAA LAA LAA LAA LAA LAA LAA KAA KAA LAA LAA LAA LAA LAA LAA LAA LAA KAA AAA AAA AAA AAA AAA AAA AAA KAA LAA LAA LAA LAA LAA LAA LAA LAA KAA LAA LAA LAA LAA LAA LAA LAA LAA KAA LAA LAA LAA LAA LAA LAA KAA AAA AAA AAA AAA AAA DAA AAA AAA AAA AAA AAA AAA JAA JAA LAA JAA JAA JAA JAA JAA JAA AAA AAA AAA AAA
AAA AAA AAA AAA AAA KAA LAA LAA LAA LAA LAA LAA LAA LAA LAA LAA LAA LAA LAA LAA LAA KAA LAA LAA LAA LAA LAA LAA LAA LAA LAA KAA AAA AAA AAA AAA AAA AAA AAA KAA LAA LAA LAA LAA LAA LAA LAA KAA KAA LAA LAA LAA LAA LAA LAA LAA LAA LAA LAA LAA LAA LAA LAA LAA KAA AAA AAA AAA AAA AAA DAA AAA AAA AAA AAA AAA AAA JAA JAA JAA JAA JAA JAA JAA JAA AAA AAA AAA AAA AAA
AAA AAA AAA AAA AAA KAA LAA LAA LAA LAA LAA LAA LAA LAA LAA LAA JAA JAA LAA LAA LAA KAA LAA LAA LAA LAA LAA LAA LAA LAA LAA KAA AAA AAA AAA AAA AAA AAA AAA KAA KAA KAA KAA KAA KAA KAA KAA KAA KAA KAA KAA KAA LAA LAA KAA KAA KAA KAA KAA KAA KAA KAA KAA KAA KAA AAA AAA AAA AAA AAA FAA AAA AAA AAA AAA AAA AAA AAA JAA JAA AAA AAA AAA AAA AAA AAA AAA AAA AAA AAA
AAA AAA AAA AAA AAA KAA LAA LAA LAA LAA LAA LAA LAA LAA LAA LAA JAA JAA LAA LAA LAA LAA LAA LAA LAA LAA LAA LAA LAA LAA LAA KAA AAA AAA AAA AAA AAA AAA AAA KAA LAA LAA LAA LAA KAA LAA LAA LAA LAA LAA LAA LAA LAA LAA LAA LAA LAA LAA LAA LAA LAA LAA LAA LAA KAA AAA AAA AAA AAA AAA DAA AAA AAA AAA AAA AAA AAA AAA JAA JAA AAA AAA AAA AAA AAA AAA AAA AAA AAA AAA
AAA AAA AAA AAA AAA KAA LAA LAA LAA LAA LAA LAA LAA LAA LAA LAA JAA JAA LAA LAA LAA LAA LAA LAA LAA LAA LAA LAA LAA LAA LAA KAA AAA AAA AAA AAA AAA AAA AAA KAA LAA LAA LAA LAA KAA LAA LAA LAA LAA LAA LAA LAA LAA LAA LAA LAA LAA LAA LAA LAA LAA LAA LAA LAA KAA AAA AAA AAA AAA AAA DAA AAA AAA AAA AAA AAA AAA AAA JAA JAA AAA AAA AAA AAA AAA AAA AAA AAA AAA AAA
AAA AAA AAA AAA AAA KAA LAA LAA LAA LAA LAA LAA LAA LAA LAA LAA JAA JAA LAA LAA LAA LAA LAA LAA LAA LAA LAA LAA LAA LAA LAA KAA AAA AAA AAA AAA AAA AAA AAA KAA LAA LAA LAA LAA KAA LAA LAA LAA LAA LAA LAA LAA LAA LAA LAA LAA LAA LAA LAA LAA LAA LAA LAA LAA KAA AAA AAA AAA AAA AAA DAA AAA AAA AAA AAA AAA AAA AAA JAA JAA AAA AAA AAA AAA AAA AAA AAA AAA AAA AAA
AAA AAA AAA AAA AAA KAA KAA KAA KAA KAA KAA KAA KAA KAA KAA KAA JAA JAA KAA KAA KAA KAA KAA KAA KAA KAA KAA KAA KAA KAA KAA KAA AAA AAA AAA AAA AAA AAA AAA KAA LAA LAA LAA LAA KAA LAA LAA LAA LAA LAA LAA LAA LAA LAA LAA LAA LAA LAA LAA LAA LAA LAA LAA LAA KAA AAA AAA AAA AAA AAA DAA AAA AAA AAA AAA AAA AAA AAA JAA JAA AAA AAA AAA AAA AAA AAA AAA AAA AAA AAA
AAA AAA AAA AAA AAA AAA AAA AAA AAA AAA AAA AAA AAA AAA AAA AAA JAA JAA AAA AAA AAA AAA AAA AAA AAA AAA AAA AAA AAA AAA AAA AAA AAA AAA AAA AAA AAA AAA AAA KAA LAA LAA LAA LAA KAA LAA LAA LAA LAA LAA LAA LAA LAA LAA LAA LAA LAA LAA LAA LAA LAA LAA LAA LAA KAA AAA AAA AAA AAA AAA DAA AAA AAA AAA AAA AAA AAA AAA JAA JAA AAA AAA AAA AAA AAA AAA AAA AAA AAA AAA
AAA AAA AAA AAA AAA AAA AAA AAA AAA AAA AAA AAA AAA AAA AAA AAA JAA JAA AAA AAA AAA AAA AAA AAA AAA AAA AAA AAA AAA AAA AAA AAA AAA AAA AAA AAA AAA AAA AAA KAA LAA LAA LAA LAA KAA LAA LAA LAA LAA LAA LAA LAA LAA LAA LAA LAA LAA LAA LAA LAA LAA LAA LAA LAA KAA AAA AAA AAA AAA AAA DAA AAA AAA AAA AAA AAA AAA AAA JAA JAA AAA AAA AAA AAA AAA AAA AAA AAA AAA AAA
AAA AAA AAA AAA AAA AAA AAA AAA AAA AAA AAA AAA AAA AAA AAA AAA JAA JAA AAA AAA AAA AAA AAA AAA AAA AAA AAA AAA AAA AAA AAA AAA AAA AAA AAA AAA AAA AAA AAA KAA LAA LAA LAA LAA KAA KAA LAA LAA LAA LAA LAA LAA LAA LAA LAA LAA LAA LAA LAA KAA KAA KAA KAA KAA KAA AAA AAA AAA AAA AAA DAA AAA AAA AAA AAA AAA AAA AAA JAA JAA AAA AAA AAA AAA AAA AAA AAA AAA AAA AAA
AAA AAA AAA AAA AAA AAA AAA AAA AAA AAA AAA AAA AAA AAA AAA AAA JAA JAA BAA BAA BAA BAA AAA AAA AAA AAA AAA AAA AAA AAA AAA AAA AAA AAA AAA AAA AAA AAA AAA KAA LAA LAA LAA LAA LAA KAA LAA LAA LAA LAA LAA LAA LAA LAA LAA KAA KAA KAA KAA KAA LAA LAA LAA KAA AAA AAA AAA AAA AAA AAA AAA AAA AAA AAA AAA AAA AAA AAA JAA JAA AAA AAA AAA AAA AAA AAA AAA AAA AAA AAA
AAA AAA AAA AAA AAA AAA AAA AAA AAA AAA AAA AAA AAA AAA AAA AAA JAA JAA BAA BAA BAA BAA BAA BAA AAA AAA AAA AAA AAA AAA AAA AAA AAA AAA AAA AAA AAA AAA AAA KAA LAA LAA LAA LAA LAA LAA LAA LAA LAA LAA LAA LAA LAA LAA LAA LAA LAA LAA LAA LAA LAA LAA LAA KAA AAA AAA AAA AAA AAA AAA AAA AAA AAA AAA AAA AAA AAA AAA JAA JAA AAA AAA AAA AAA AAA AAA AAA AAA AAA AAA
AAA AAA AAA AAA AAA AAA AAA AAA AAA AAA AAA AAA AAA AAA AAA JAA JAA JAA BAA BAA BAA BAA BAA BAA BAA AAA AAA AAA AAA AAA AAA AAA AAA AAA AAA AAA AAA AAA AAA KAA LAA LAA LAA LAA LAA KAA LAA LAA LAA LAA LAA LAA JAA JAA LAA LAA LAA LAA LAA LAA LAA LAA LAA KAA AAA AAA AAA AAA AAA AAA AAA AAA AAA AAA AAA AAA AAA AAA JAA JAA AAA AAA AAA AAA AAA AAA AAA AAA AAA AAA
AAA AAA AAA AAA AAA AAA AAA AAA AAA AAA AAA AAA AAA AAA AAA JAA JAA BAA BAA BAA BAA BAA BAA BAA BAA BAA AAA AAA AAA AAA AAA AAA AAA AAA AAA AAA AAA AAA AAA KAA KAA KAA KAA KAA KAA KAA KAA KAA KAA KAA KAA KAA JAA JAA KAA KAA KAA KAA KAA KAA KAA KAA KAA KAA AAA AAA AAA AAA AAA AAA AAA AAA AAA AAA AAA AAA AAA AAA JAA JAA AAA AAA AAA AAA AAA AAA AAA AAA AAA AAA
AAA AAA AAA AAA AAA AAA AAA AAA AAA AAA AAA AAA AAA AAA AAA JAA JAA BAA BAA BAA BAA BAA BAA BAA BAA BAA BAA BAA AAA AAA AAA AAA AAA AAA AAA AAA AAA AAA AAA AAA AAA AAA AAA AAA AAA AAA AAA AAA AAA AAA KAA KAA JAA JAA AAA AAA AAA AAA AAA AAA AAA AAA AAA AAA AAA AAA AAA AAA AAA AAA AAA AAA AAA AAA AAA AAA AAA AAA JAA JAA AAA AAA AAA AAA AAA AAA AAA AAA AAA AAA
AAA AAA AAA AAA AAA AAA AAA AAA AAA AAA AAA AAA AAA AAA AAA JAA JAA BAA BAA BAA BAA BAA BAA BAA BAA BAA BAA BAA BAA BAA BAA AAA AAA AAA AAA AAA AAA AAA AAA AAA AAA AAA AAA AAA AAA AAA AAA AAA AAA AAA AAA AAA JAA JAA AAA AAA AAA AAA AAA AAA AAA AAA AAA AAA AAA AAA AAA AAA AAA AAA AAA AAA AAA AAA AAA AAA AAA AAA JAA JAA AAA AAA AAA AAA AAA AAA AAA AAA AAA AAA
AAA AAA AAA AAA AAA AAA AAA AAA AAA AAA AAA AAA AAA AAA AAA JAA JAA BAA BAA BAA BAA BAA BAA BAA BAA BAA BAA BAA BAA BAA BAA BAA AAA AAA AAA AAA AAA AAA AAA AAA AAA AAA AAA AAA AAA AAA AAA AAA AAA AAA AAA AAA JAA JAA AAA AAA AAA AAA AAA AAA AAA AAA AAA AAA AAA AAA AAA AAA AAA AAA AAA AAA AAA AAA AAA AAA AAA AAA JAA JAA AAA AAA AAA AAA AAA AAA AAA AAA AAA AAA
AAA EAA JAA JAA JAA JAA JAA JAA JAA JAA JAA JAA JAA JAA JAA JAA JAA JAA JAA JAA JAA JAA JAA JAA JAA JAA JAA JAA JAA JAA JAA JAA JAA JAA JAA JAA JAA JAA JAA JAA JAA JAA JAA JAA JAA JAA JAA JAA JAA JAA JAA JAA JAA JAA JAA JAA JAA JAA JAA JAA JAA JAA JAA JAA JAA JAA JAA JAA JAA JAA JAA JAA JAA JAA JAA JAA JAA JAA JAA JAA JAA JAA JAA JAA JAA JAA JAA EAA AAA AAA
AAA EAA JAA JAA JAA JAA JAA JAA JAA JAA JAA JAA JAA JAA JAA JAA JAA JAA JAA JAA JAA JAA JAA JAA JAA JAA JAA JAA JAA JAA JAA JAA JAA JAA JAA JAA JAA JAA JAA JAA JAA JAA JAA JAA JAA JAA JAA JAA JAA JAA JAA JAA JAA JAA JAA JAA JAA JAA JAA JAA JAA JAA JAA JAA JAA JAA JAA JAA JAA JAA JAA JAA JAA JAA JAA JAA JAA JAA JAA JAA JAA JAA JAA JAA JAA JAA JAA EAA AAA AAA
AAA EAA JAA JAA JAA JAA JAA JAA JAA JAA JAA JAA JAA JAA JAA JAA JAA JAA JAA JAA JAA JAA JAA JAA JAA JAA JAA JAA JAA JAA JAA JAA JAA JAA JAA JAA JAA JAA JAA JAA JAA JAA JAA JAA JAA JAA JAA JAA JAA JAA JAA JAA JAA JAA JAA JAA JAA JAA JAA JAA JAA JAA JAA JAA JAA JAA JAA JAA JAA JAA JAA JAA JAA JAA JAA JAA JAA JAA JAA JAA JAA JAA JAA JAA JAA JAA JAA EAA AAA AAA
AAA AAA AAA AAA AAA AAA AAA AAA AAA AAA AAA AAA AAA AAA AAA AAA AAA AAA AAA AAA AAA AAA AAA AAA AAA AAA JAA JAA BAA BAA BAA BAA BAA BAA BAA BAA BAA BAA BAA BAA BAA AAA AAA AAA AAA AAA AAA AAA AAA AAA AAA AAA AAA AAA AAA AAA AAA AAA AAA AAA AAA AAA AAA AAA BAA BAA BAA BAA BAA BAA BAA BAA BAA BAA JAA JAA AAA AAA AAA AAA AAA AAA AAA AAA AAA AAA JAA AAA AAA AAA
AAA AAA AAA AAA AAA AAA AAA AAA AAA AAA AAA AAA AAA AAA AAA AAA AAA AAA AAA AAA AAA AAA AAA AAA AAA AAA JAA JAA BAA BAA BAA BAA BAA BAA BAA BAA BAA BAA BAA BAA BAA AAA AAA AAA AAA AAA AAA AAA AAA AAA AAA AAA AAA AAA AAA AAA AAA AAA AAA AAA AAA AAA AAA AAA BAA BAA BAA BAA BAA BAA BAA BAA BAA BAA JAA JAA AAA AAA AAA AAA BAA BAA BAA BAA AAA AAA AAA AAA AAA AAA
AAA AAA AAA AAA AAA AAA AAA AAA AAA AAA AAA AAA AAA AAA AAA AAA AAA AAA AAA AAA AAA AAA AAA AAA AAA AAA JAA JAA BAA BAA BAA BAA BAA BAA BAA BAA BAA BAA BAA BAA AAA AAA AAA AAA AAA AAA AAA AAA AAA AAA AAA AAA AAA AAA AAA AAA AAA AAA AAA AAA AAA AAA AAA AAA AAA BAA BAA BAA BAA BAA BAA BAA BAA BAA JAA JAA JAA AAA AAA BAA BAA BAA BAA BAA BAA BAA AAA AAA AAA AAA
AAA AAA AAA AAA AAA AAA AAA AAA AAA AAA AAA AAA AAA AAA AAA AAA AAA AAA AAA AAA AAA AAA AAA AAA AAA AAA JAA JAA BAA BAA BAA BAA BAA BAA BAA BAA BAA BAA BAA AAA AAA AAA AAA AAA AAA AAA AAA AAA AAA AAA AAA AAA AAA AAA AAA AAA AAA AAA AAA AAA AAA AAA AAA AAA AAA AAA BAA BAA BAA BAA BAA BAA BAA BAA JAA JAA JAA JAA JAA JAA JAA BAA BAA BAA BAA BAA BAA AAA AAA AAA
AAA AAA AAA AAA AAA AAA AAA AAA AAA AAA AAA AAA AAA AAA AAA AAA AAA AAA AAA AAA AAA AAA AAA AAA AAA AAA JAA JAA BAA BAA BAA BAA BAA BAA BAA BAA BAA BAA AAA AAA AAA AAA AAA AAA AAA AAA AAA AAA AAA AAA AAA AAA AAA AAA AAA AAA AAA AAA AAA AAA AAA AAA AAA AAA AAA AAA AAA AAA BAA BAA BAA BAA BAA BAA JAA JAA JAA JAA JAA JAA JAA BAA BAA BAA BAA BAA BAA AAA AAA AAA
AAA AAA AAA AAA AAA AAA AAA AAA AAA AAA AAA AAA AAA AAA AAA AAA AAA AAA AAA AAA AAA AAA AAA AAA AAA AAA JAA JAA BAA BAA BAA BAA BAA BAA BAA BAA AAA AAA AAA AAA AAA AAA AAA AAA AAA AAA AAA AAA AAA AAA AAA AAA AAA AAA AAA AAA AAA AAA AAA AAA AAA AAA AAA AAA AAA AAA AAA AAA AAA AAA AAA BAA BAA BAA JAA JAA JAA AAA AAA BAA BAA BAA BAA BAA BAA BAA BAA AAA AAA AAA
AAA AAA AAA AAA AAA AAA AAA AAA AAA AAA AAA AAA AAA AAA AAA AAA AAA AAA AAA AAA KAA KAA KAA KAA KAA KAA JAA JAA KAA KAA KAA KAA KAA KAA KAA KAA KAA AAA AAA AAA AAA AAA AAA AAA AAA AAA AAA AAA AAA AAA AAA AAA AAA AAA AAA AAA AAA AAA AAA AAA AAA AAA AAA AAA AAA AAA AAA AAA AAA AAA AAA AAA AAA AAA JAA JAA AAA AAA AAA BAA BAA BAA BAA BAA BAA BAA BAA AAA AAA AAA
AAA AAA AAA AAA AAA AAA AAA AAA AAA AAA AAA AAA AAA AAA AAA AAA AAA AAA KAA KAA KAA LAA LAA LAA KAA LAA JAA JAA LAA LAA LAA LAA LAA LAA LAA LAA KAA AAA AAA AAA AAA AAA AAA AAA AAA AAA AAA AAA AAA AAA AAA AAA AAA AAA AAA AAA AAA AAA AAA AAA AAA AAA AAA AAA AAA AAA AAA AAA AAA AAA AAA AAA AAA AAA JAA JAA AAA AAA AAA AAA AAA BAA BAA BAA BAA BAA AAA AAA AAA AAA
AAA AAA AAA AAA AAA AAA AAA AAA AAA AAA AAA AAA AAA AAA AAA AAA AAA AAA KAA LAA LAA LAA LAA LAA KAA LAA JAA JAA LAA LAA LAA LAA LAA LAA LAA LAA KAA AAA AAA AAA AAA AAA AAA AAA AAA AAA DAA DAA DAA DAA DAA DAA DAA DAA DAA DAA DAA AAA AAA AAA AAA AAA AAA AAA AAA AAA AAA AAA AAA AAA AAA AAA AAA AAA JAA JAA AAA AAA AAA AAA AAA AAA AAA AAA AAA AAA AAA AAA AAA AAA
AAA AAA AAA AAA AAA AAA AAA AAA AAA AAA AAA AAA AAA AAA AAA AAA AAA AAA KAA LAA MAA LAA LAA LAA LAA LAA JAA JAA LAA LAA LAA LAA LAA LAA LAA LAA LAA KAA AAA AAA AAA AAA AAA AAA AAA DAA DAA DAA DAA DAA DAA DAA DAA DAA DAA DAA DAA DAA AAA AAA AAA AAA AAA AAA AAA AAA AAA AAA AAA AAA AAA AAA AAA AAA JAA JAA AAA AAA AAA AAA AAA AAA AAA AAA AAA AAA AAA AAA AAA AAA
AAA AAA AAA AAA AAA AAA AAA AAA AAA AAA AAA AAA AAA AAA AAA AAA AAA AAA KAA LAA LAA LAA LAA LAA KAA LAA LAA LAA LAA LAA LAA LAA LAA LAA LAA LAA LAA KAA AAA AAA AAA AAA AAA AAA DAA DAA DAA DAA DAA DAA DAA DAA DAA DAA DAA DAA DAA DAA DAA AAA AAA AAA AAA AAA AAA AAA AAA AAA AAA AAA AAA AAA AAA AAA JAA JAA AAA AAA AAA AAA AAA AAA AAA AAA AAA AAA AAA AAA AAA AAA
AAA AAA AAA AAA AAA AAA AAA AAA AAA AAA AAA AAA AAA AAA AAA AAA AAA AAA KAA LAA LAA LAA LAA LAA KAA LAA LAA LAA LAA LAA LAA LAA LAA LAA LAA LAA LAA KAA AAA AAA AAA AAA AAA AAA DAA DAA DAA DAA DAA DAA DAA DAA DAA DAA DAA DAA DAA DAA DAA DAA AAA AAA AAA AAA AAA AAA AAA AAA AAA AAA AAA AAA AAA AAA JAA JAA KAA KAA KAA KAA KAA KAA KAA KAA KAA KAA AAA AAA AAA AAA
AAA AAA AAA AAA AAA AAA AAA AAA AAA AAA AAA AAA AAA AAA AAA AAA AAA AAA KAA LAA LAA LAA LAA LAA KAA LAA LAA LAA LAA LAA LAA LAA LAA LAA LAA LAA LAA KAA AAA AAA AAA AAA AAA DAA DAA DAA DAA DAA DAA DAA DAA DAA DAA DAA DAA DAA DAA DAA DAA DAA DAA AAA AAA AAA AAA AAA KAA KAA KAA KAA KAA KAA KAA KAA JAA JAA LAA LAA LAA LAA LAA KAA LAA LAA LAA KAA AAA AAA AAA AAA
AAA AAA AAA AAA AAA AAA AAA AAA AAA AAA AAA AAA AAA AAA AAA AAA AAA AAA KAA KAA KAA KAA KAA KAA KAA LAA LAA LAA LAA LAA LAA LAA LAA LAA LAA LAA LAA KAA AAA AAA AAA AAA AAA DAA DAA DAA DAA DAA DAA DAA DAA AAA AAA AAA AAA DAA DAA DAA DAA DAA DAA AAA AAA AAA AAA AAA KAA LAA LAA LAA LAA LAA LAA LAA JAA JAA LAA LAA LAA LAA LAA KAA LAA LAA LAA KAA AAA AAA AAA AAA
AAA AAA AAA AAA AAA AAA AAA AAA AAA AAA AAA AAA AAA AAA AAA AAA AAA AAA KAA LAA LAA LAA LAA LAA LAA LAA LAA LAA LAA LAA LAA LAA LAA LAA LAA LAA LAA KAA AAA AAA AAA AAA AAA DAA DAA DAA DAA DAA DAA DAA DAA AAA AAA IAA AAA DAA DAA DAA DAA DAA DAA DAA AAA AAA AAA AAA KAA KAA LAA LAA LAA LAA LAA LAA JAA JAA LAA LAA LAA LAA LAA KAA LAA LAA LAA LAA KAA AAA AAA AAA
AAA AAA AAA AAA AAA AAA AAA AAA AAA AAA AAA AAA AAA AAA AAA AAA AAA AAA KAA LAA LAA LAA LAA LAA LAA LAA LAA LAA KAA KAA KAA KAA KAA KAA LAA LAA KAA KAA AAA AAA AAA AAA AAA FAA FAA FAA FAA FAA FAA FAA FAA AAA AAA AAA AAA DAA DAA DAA DAA DAA DAA DAA AAA AAA AAA AAA AAA KAA LAA LAA LAA LAA LAA LAA JAA JAA LAA LAA LAA LAA LAA KAA LAA LAA LAA LAA KAA AAA AAA AAA
AAA AAA AAA AAA AAA AAA AAA AAA AAA AAA AAA AAA AAA AAA AAA AAA AAA AAA KAA LAA LAA LAA LAA LAA LAA LAA LAA LAA KAA LAA LAA LAA LAA LAA LAA LAA LAA KAA AAA AAA AAA AAA AAA FAA DAA DAA DAA DAA DAA DAA DAA AAA AAA AAA AAA DAA DAA DAA DAA DAA DAA DAA AAA AAA AAA AAA AAA KAA LAA LAA LAA LAA LAA LAA JAA JAA LAA LAA LAA LAA LAA KAA LAA LAA LAA LAA KAA AAA AAA AAA
AAA AAA AAA AAA AAA AAA AAA AAA AAA AAA AAA AAA AAA AAA AAA AAA AAA AAA KAA LAA LAA LAA LAA LAA LAA LAA LAA LAA KAA LAA LAA LAA LAA LAA LAA LAA LAA KAA AAA AAA AAA AAA AAA AAA DAA DAA DAA DAA DAA DAA DAA DAA DAA DAA DAA DAA DAA DAA DAA DAA DAA DAA AAA AAA AAA AAA AAA KAA LAA LAA LAA LAA LAA LAA JAA JAA LAA LAA LAA LAA LAA KAA LAA LAA LAA LAA KAA AAA AAA AAA
AAA AAA AAA AAA AAA AAA AAA AAA AAA AAA AAA AAA AAA AAA AAA AAA AAA AAA KAA LAA LAA LAA LAA LAA LAA LAA LAA LAA KAA LAA LAA LAA LAA LAA LAA LAA LAA KAA AAA AAA AAA AAA AAA AAA DAA DAA DAA DAA DAA DAA DAA DAA DAA DAA DAA DAA DAA DAA DAA DAA DAA DAA AAA AAA AAA AAA AAA KAA KAA LAA LAA LAA LAA LAA LAA LAA LAA LAA LAA LAA LAA KAA KAA LAA LAA LAA KAA AAA AAA AAA
AAA AAA AAA AAA AAA AAA AAA AAA AAA AAA AAA AAA AAA AAA AAA AAA AAA AAA KAA LAA LAA LAA LAA LAA LAA LAA LAA LAA KAA LAA LAA LAA LAA LAA MAA LAA LAA KAA AAA AAA AAA AAA AAA AAA AAA DAA DAA DAA DAA DAA DAA DAA DAA DAA DAA DAA DAA DAA DAA DAA DAA DAA AAA AAA AAA AAA AAA AAA KAA LAA LAA LAA LAA LAA LAA LAA LAA LAA LAA LAA LAA LAA LAA LAA LAA LAA KAA AAA AAA AAA
AAA AAA AAA AAA AAA AAA AAA AAA AAA AAA AAA AAA AAA AAA AAA AAA AAA AAA KAA LAA LAA LAA LAA LAA LAA LAA LAA LAA KAA KAA LAA LAA LAA LAA LAA LAA LAA KAA AAA AAA AAA AAA AAA AAA AAA DAA DAA DAA DAA DAA DAA DAA DAA DAA DAA DAA DAA DAA DAA DAA DAA AAA AAA AAA AAA AAA AAA AAA KAA KAA KAA KAA KAA KAA KAA KAA KAA KAA KAA KAA LAA LAA LAA LAA LAA LAA KAA AAA AAA AAA
AAA AAA AAA AAA AAA AAA AAA AAA AAA AAA AAA AAA AAA AAA AAA AAA AAA AAA KAA KAA KAA KAA KAA LAA LAA LAA LAA LAA LAA KAA LAA LAA LAA LAA LAA LAA LAA KAA AAA AAA AAA AAA AAA AAA AAA AAA DAA DAA DAA DAA DAA DAA DAA DAA DAA DAA DAA DAA DAA DAA DAA AAA AAA AAA AAA AAA AAA AAA KAA LAA LAA LAA LAA LAA LAA LAA LAA LAA LAA KAA KAA KAA KAA LAA LAA LAA KAA AAA AAA AAA
AAA AAA AAA AAA AAA AAA AAA AAA AAA AAA AAA AAA AAA AAA AAA AAA AAA AAA AAA AAA AAA AAA KAA KAA KAA KAA KAA KAA KAA KAA KAA LAA LAA LAA LAA LAA LAA KAA AAA AAA AAA AAA AAA AAA AAA AAA AAA AAA DAA DAA DAA DAA DAA DAA DAA DAA DAA DAA DAA DAA AAA AAA AAA AAA AAA AAA AAA AAA KAA LAA LAA LAA LAA LAA LAA LAA LAA LAA LAA LAA LAA LAA LAA LAA LAA LAA KAA AAA AAA AAA
AAA AAA AAA AAA AAA AAA AAA AAA AAA AAA AAA AAA AAA AAA AAA AAA AAA AAA AAA AAA AAA AAA AAA AAA AAA AAA AAA AAA AAA AAA AAA KAA KAA KAA KAA KAA KAA KAA AAA AAA AAA AAA AAA AAA AAA AAA AAA AAA AAA AAA DAA DAA DAA DAA DAA DAA DAA DAA DAA AAA AAA AAA AAA AAA AAA AAA AAA AAA KAA LAA LAA LAA LAA LAA MAA LAA LAA LAA LAA LAA LAA LAA LAA LAA LAA LAA KAA AAA AAA AAA
AAA AAA AAA AAA AAA AAA AAA AAA AAA AAA AAA AAA AAA AAA AAA AAA AAA AAA AAA AAA AAA AAA AAA AAA AAA AAA AAA AAA AAA AAA AAA AAA AAA AAA AAA AAA AAA AAA AAA AAA AAA AAA AAA AAA AAA AAA AAA AAA AAA AAA AAA AAA AAA AAA AAA AAA AAA AAA AAA AAA AAA AAA AAA AAA AAA AAA AAA AAA KAA LAA LAA LAA LAA LAA LAA LAA LAA LAA LAA LAA LAA LAA LAA LAA LAA LAA KAA AAA AAA AAA
AAA AAA AAA AAA AAA AAA AAA AAA AAA AAA AAA AAA AAA AAA AAA AAA AAA AAA AAA AAA AAA AAA AAA AAA AAA AAA AAA AAA AAA AAA AAA AAA AAA AAA AAA AAA AAA AAA AAA AAA AAA AAA AAA AAA AAA AAA AAA AAA AAA AAA AAA AAA AAA AAA AAA AAA AAA AAA AAA AAA AAA AAA AAA AAA AAA AAA AAA AAA KAA KAA LAA LAA LAA LAA LAA LAA LAA LAA LAA LAA LAA LAA LAA LAA LAA LAA KAA AAA AAA AAA
AAA AAA AAA AAA AAA AAA AAA AAA AAA AAA AAA AAA AAA AAA AAA AAA AAA AAA AAA AAA AAA AAA AAA AAA AAA AAA AAA AAA AAA AAA AAA AAA AAA AAA AAA AAA AAA AAA AAA AAA AAA AAA AAA AAA AAA AAA AAA AAA AAA AAA AAA AAA AAA AAA AAA AAA AAA AAA AAA AAA AAA AAA AAA AAA AAA AAA AAA AAA AAA KAA KAA KAA KAA KAA KAA KAA KAA KAA KAA KAA KAA KAA KAA KAA KAA KAA KAA AAA AAA AAA
AAA AAA AAA AAA AAA AAA AAA AAA AAA AAA AAA AAA AAA AAA AAA AAA AAA AAA AAA AAA AAA AAA AAA AAA AAA AAA AAA AAA AAA AAA AAA AAA AAA AAA AAA AAA AAA AAA AAA AAA AAA AAA AAA AAA AAA AAA AAA AAA AAA AAA AAA AAA AAA AAA AAA AAA AAA AAA AAA AAA AAA AAA AAA AAA AAA AAA AAA AAA AAA AAA AAA AAA AAA AAA AAA AAA AAA AAA AAA AAA AAA AAA AAA AAA AAA AAA AAA AAA AAA AAA
AAA AAA AAA AAA AAA AAA AAA AAA AAA AAA AAA AAA AAA AAA AAA AAA AAA AAA AAA AAA AAA AAA AAA AAA AAA AAA AAA AAA AAA AAA AAA AAA AAA AAA AAA AAA AAA AAA AAA AAA AAA AAA AAA AAA AAA AAA AAA AAA AAA AAA AAA AAA AAA AAA AAA AAA AAA AAA AAA AAA AAA AAA AAA AAA AAA AAA AAA AAA AAA AAA AAA AAA AAA AAA AAA AAA AAA AAA AAA AAA AAA AAA AAA AAA AAA AAA AAA AAA AAA AAA
AAA AAA AAA AAA AAA AAA AAA AAA AAA AAA AAA AAA AAA AAA AAA AAA AAA AAA AAA AAA AAA AAA AAA AAA AAA AAA AAA AAA AAA AAA AAA AAA AAA AAA AAA AAA AAA AAA AAA AAA AAA AAA AAA AAA AAA AAA AAA AAA AAA AAA AAA AAA AAA AAA AAA AAA AAA AAA AAA AAA AAA AAA AAA AAA AAA AAA AAA AAA AAA AAA AAA AAA AAA AAA AAA AAA AAA AAA AAA AAA AAA AAA AAA AAA AAA AAA AAA AAA AAA AAA
AAA AAA AAA AAA AAA AAA AAA AAA AAA AAA AAA AAA AAA AAA AAA AAA AAA AAA AAA AAA AAA AAA AAA AAA AAA AAA AAA AAA AAA AAA AAA AAA AAA AAA AAA AAA AAA AAA AAA AAA AAA AAA AAA AAA AAA AAA AAA AAA AAA AAA AAA AAA AAA AAA AAA AAA AAA AAA AAA AAA AAA AAA AAA AAA AAA AAA AAA AAA AAA AAA AAA AAA AAA AAA AAA AAA AAA AAA AAA AAA AAA AAA AAA AAA AAA AAA AAA AAA AAA AAA
AAA AAA AAA AAA AAA AAA AAA AAA AAA AAA AAA AAA AAA AAA AAA AAA AAA AAA AAA AAA AAA AAA AAA AAA AAA AAA AAA AAA AAA AAA AAA AAA AAA AAA AAA AAA AAA AAA AAA AAA AAA AAA AAA AAA AAA AAA AAA AAA AAA AAA AAA AAA AAA AAA AAA AAA AAA AAA AAA AAA AAA AAA AAA AAA AAA AAA AAA AAA AAA AAA AAA AAA AAA AAA AAA AAA AAA AAA AAA AAA AAA AAA AAA AAA AAA AAA AAA AAA AAA AAA
