T T T T T T U
T T `EAG T T T U
U a T a U U U
T T TDB T T T U
T T T T T T U
T T T T T T U
T T T T T T U
T T T T T T U
T T T T T T U
T T T T T T U
T T T T T T U
T T T T T T U
T T T T T T U
T T T T T T U
T T T T T T U
T T T T T T U
T T T T T T U
T T T T T T U
T T T T T T U
T T T T T T U
T T T T T T U
T T T T T T U
T T T T T T U
T T T T T T U
T T T T T T U
T T T T T T U
T T T T T T U
T \BHEAAC T T T T U
T T T T T T U
U U U U U U U