U U U U U U U U U U U U U U U U U U U U U U U U U U U U U U
U T T T T T T T T T T T T T T T T T T T T T T T U T T T T U
U T T T T T T T T T T T T T T T T T T T T T T T T T T T T U
U T T \BIEAAC T T T T T T T T T T T T T T T T T T T T T T T T T U
U T T T T T T T T T T T T T T T T T T T T T T T U T T T T U
U T T T T T T T T T T T T T T T T T T T T T T T U T T T T U
U T T T T T T T T T T T T T T T T T T T T T T T U T T T T U
U U U U U U U U U U U U U U U U U U U U U U U U U T T T T U
U T T T T T T T T T T `EGB T T T T T T T T T T T T T T T T T U
U T T T T T T T T T T T T T T T T T T T T T T T T T T T T U
U T T T T T U U U U U U U U U U U U U U U U U U U U U U U U
U T T T T T T T T T T T T T T T T T T T T T T T U T T T T U
U T T T T T T T T T T T T T T T T T T T T T T T U T T T T U
U T T T T T T T T T T T T T T T T T T T T T T T U T T T T U
U T T T T T T T T T T T T T T T T T T T T T T T U T T T T U
U T T T T T T T T T T T T T T T T T T T T T T T U T T T T U
U T T T T T T T T T T T T T T T T T T T T T T T U T T T T U
U T T T T T T T T T T T T T T T T T T T T T T T U T T T T U
U T T T T T T T T T T T T T T T T T T T T T T T T T T T T U
U T T T T T T T T T T T T T T T T T T T T T T T T T T T T U
U T T T T T T T T T T T T T T T T T T T T T T T T T T T T U
U U U U U U U U U U U U U U U U U U U U U U U U U T T U U U
U T T T T T T T T T T T T T T T T T T T T T T T U T T T T U
U T T T T T T T T T T T T T T T T T T T T T T T U T T T T U
U T T T T T T T T T T T T T T T T T T T T T T T T T T T T U
U T T T T T T T T T T T T T T T T T T T T T T T T T T T T U
U T T T T T T T T T T T T T T T T T T T T T T T U T T T T U
U T T T T T T T T T T T T T T T T T T T T T T T U T T T T U
U T T T T T T T T T T T T T T T T T T T T T T T U T T T T U
U U U U U U U U U U U U U U U U U U U U U U U U U T T T T U
U T T T T T T T T U T T T T T T T T T T T T T T T T T T T U
U T T T T T T T T U T T T T T T T T T T T T T T T T T T T U
U T T T T T T T T U T T T T T T T T T T T T T T T T T T T U
U T T T T T T T T U T T T T T T T T T T T T T T T T T T T U
U T T T T T T T T U T T T T T T T T T T T T T T T T T T T U
U T \BGEAAC T T T T T T U T T T T T T T T T T T T T T T T T T T U
U T T T T T T T T T T T T T T T T T T T T T T T T T T T T U
U T T T T T T T T U T T T T T T T T T T T T T T T T T T T U
U T T T T T T T T U T T T T T T T T T T T T T T T T T T T U
U T T T T T T T T U T T T T T T T T T T T T T T T T T T T U
U T T T T T T T T U T T T T T T T T T T T T T T T T T T T U
U U U U U U U U U U U U U U U U U U U U U U U U U U U U U U