A B C D E F G H I J K L M A A A A A A A A A A A A A A A A A A A A A A A A A A A A A A A A A A A A A A A A A A A A A A A A A A A A A A A A A A A A A A A A A A A A A A A A A A A A A
A A A A A A A A A A A A A A A A A A A A A A A A A A A A A A A A A A A A A A A A A A A A A A A A A A A A A A A A A A A A D D D D D D D D A A A A A A A A A A A A A A A A A A A A A A
A A A A A A A A A A A A A A A A A A A A A A A A A A A A A A A A A A A A A A A A A A A A A A A A A A D D D D D D D D D D D D D D D D D D A A A A A A A A A A A A A A A A A A A A A A
A A A A A A A A A A A A A A A A A A A A A A A A A A A A A A A A A A A A A A A A D D D D D D D D D D D D D D D D D D D D D D D D D D D D D A A A A A A A A A A A A A A A A A A A A A
A A A A A A A A A A A A A A A A A A A A A A A A A A A A A A A A A A A A A A A A A A A A A A A A A A A A A A A A A A A A A A A A A A D D D A A A A A A A A A A A A A A A A A A A A A
A A A A A K K K K K K K K K K K K K K K K K K K K K K K K K K K A A A A A A A A A A A A A A A A A A A A A A A A A A A A A A A A A A A A D D A A A A A A A J J J J J J J J J A A A A
A A A A A K L L L L L L L L L L L L L L L L L K K L L L L L L K A A A A A A A A A A A A A A A A A A A A A A A A A A A A A A A A A A A A A D A A A A A A J J J J J J J J J J J A A A
A A A A A K L L L L L L L L L L L L L L L L L L K L L M M L L K A A A A A A A A K K K K K K K K K K K K K K K K K K K K K K K K K A A A A D D A A A A A J J L L L L L L L J J A A A
A A A A A K L L L L L L L L L L L L L L L L L L K L L L L L L K A A A A A A A A K L L L L L L L K L L L L L L L L K L L L L L L K A A A A A D A A A A A J J L D D D L L L J J A A A
A A A A A K L L L L L L L L L L L L L L L L L L L L L L L L L K A A A A A A A A K L L L L L L L L L L L L L L L L K L L L L L L K A A A A A D A A A A A J J L D D D D D L J J A A A
A A A A A K K K K K K K K K K K L L L L L L L L L L L L L L L K A A A A A A A A K L L L L L L L L L L L L L L L L K L L L L L L K A A A A A F A A A A A J J L D D D D D L J J A A A
A A A A A K L L L L L L L L L L L L L L L L L L K L L L L L L K A A A A A A A A K L L L L L L L K L L L L L L L L K L L M L L L K A A A A A D A A A A A J J L D D D D D L J J A A A
A A A A A K L L L L L L L L L L L L L L L L L L K L L L L L L K A A A A A A A A K L L L L L L L K L L L L L L L L K L L L L L L K A A A A A D A A A A A J J L F F F F F L J J A A A
A A A A A K L L L L L L L L L L L L L L L L L L K L L L L L L K A A A A A A A K K L L L L L L L K L L L L L L L L K L L L L L L K A A A A A D A A A A A J J L D D D D D L J J A A A
A A A A A K L L L L L L L L L L L L L L L L L L K L L L L L L K A A A A A A A K L L L L L L L L K L L L L L L L L K L L L L L L K A A A A A D A A A A A J J L D D D D D L J J A A A
A A A A A K L L L L L L L L L L L L L L L L L L K L L L L L L K A A A A A A A K L L L L L L L L K L L L L L L L L K L L L L L L K A A A A A D A A A A A J J L L D D D L L J J A A A
A A A A A K L L L L L L L L L L L L L L L L L L K L L L L L L K A A A A A A A K L L L M L L L L K L L L L L L L L K L L L L L L K A A A A A D A A A A A J J L L L L L L J J J A A A
A A A A A K L L L L L L L L L L L L L L L L K K K K K K K K K K A A A A A A A K L L L L L L L L K L L L L L L L L K L L L L L L K A A A A A D A A A A A J J J L L L L L J J A A A A
A A A A A K L L L L L L L L L L L L L L L K K L L L L L L L L K A A A A A A A K L L L L L L L L K L L L L L L L L K L L L L L L K A A A A A D A A A A A A J J L J J J J J J A A A A
A A A A A K L L L L L L L L L L L L L L L K L L L L L L L L L K A A A A A A A K L L L L L L L K K L L L L L L L L L L L L L L L K A A A A A D A A A A A A J J J J J J J J A A A A A
A A A A A K L L L L L L L L L L J J L L L K L L L L L L L L L K A A A A A A A K K K K K K K K K K K K K L L K K K K K K K K K K K A A A A A F A A A A A A A J J A A A A A A A A A A
A A A A A K L L L L L L L L L L J J L L L L L L L L L L L L L K A A A A A A A K L L L L K L L L L L L L L L L L L L L L L L L L K A A A A A D A A A A A A A J J A A A A A A A A A A
A A A A A K L L L L L L L L L L J J L L L L L L L L L L L L L K A A A A A A A K L L L L K L L L L L L L L L L L L L L L L L L L K A A A A A D A A A A A A A J J A A A A A A A A A A
A A A A A K L L L L L L L L L L J J L L L L L L L L L L L L L K A A A A A A A K L L L L K L L L L L L L L L L L L L L L L L L L K A A A A A D A A A A A A A J J A A A A A A A A A A
A A A A A K K K K K K K K K K K J J K K K K K K K K K K K K K K A A A A A A A K L L L L K L L L L L L L L L L L L L L L L L L L K A A A A A D A A A A A A A J J A A A A A A A A A A
A A A A A A A A A A A A A A A A J J A A A A A A A A A A A A A A A A A A A A A K L L L L K L L L L L L L L L L L L L L L L L L L K A A A A A D A A A A A A A J J A A A A A A A A A A
A A A A A A A A A A A A A A A A J J A A A A A A A A A A A A A A A A A A A A A K L L L L K L L L L L L L L L L L L L L L L L L L K A A A A A D A A A A A A A J J A A A A A A A A A A
A A A A A A A A A A A A A A A A J J A A A A A A A A A A A A A A A A A A A A A K L L L L K K L L L L L L L L L L L L L K K K K K K A A A A A D A A A A A A A J J A A A A A A A A A A
A A A A A A A A A A A A A A A A J J B B B B A A A A A A A A A A A A A A A A A K L L L L L K L L L L L L L L L K K K K K L L L K A A A A A A A A A A A A A A J J A A A A A A A A A A
A A A A A A A A A A A A A A A A J J B B B B B B A A A A A A A A A A A A A A A K L L L L L L L L L L L L L L L L L L L L L L L K A A A A A A A A A A A A A A J J A A A A A A A A A A
A A A A A A A A A A A A A A A J J J B B B B B B B A A A A A A A A A A A A A A K L L L L L K L L L L L L J J L L L L L L L L L K A A A A A A A A A A A A A A J J A A A A A A A A A A
A A A A A A A A A A A A A A A J J B B B B B B B B B A A A A A A A A A A A A A K K K K K K K K K K K K K J J K K K K K K K K K K A A A A A A A A A A A A A A J J A A A A A A A A A A
A A A A A A A A A A A A A A A J J B B B B B B B B B B B A A A A A A A A A A A A A A A A A A A A A A K K J J A A A A A A A A A A A A A A A A A A A A A A A A J J A A A A A A A A A A
A A A A A A A A A A A A A A A J J B B B B B B B B B B B B B B A A A A A A A A A A A A A A A A A A A A A J J A A A A A A A A A A A A A A A A A A A A A A A A J J A A A A A A A A A A
A A A A A A A A A A A A A A A J J B B B B B B B B B B B B B B B A A A A A A A A A A A A A A A A A A A A J J A A A A A A A A A A A A A A A A A A A A A A A A J J A A A A A A A A A A
A E J J J J J J J J J J J J J J J J J J J J J J J J J J J J J J J J J J J J J J J J J J J J J J J J J J J J J J J J J J J J J J J J J J J J J J J J J J J J J J J J J J J J J E A A
A E J J J J J J J J J J J J J J J J J J J J J J J J J J J J J J J J J J J J J J J J J J J J J J J J J J J J J J J J J J J J J J J J J J J J J J J J J J J J J J J J J J J J J E A A
A E J J J J J J J J J J J J J J J J J J J J J J J J J J J J J J J J J J J J J J J J J J J J J J J J J J J J J J J J J J J J J J J J J J J J J J J J J J J J J J J J J J J J J E A A
A A A A A A A A A A A A A A A A A A A A A A A A A A J J B B B B B B B B B B B B B A A A A A A A A A A A A A A A A A A A A A A A B B B B B B B B B B J J A A A A A A A A A A J A A A
A A A A A A A A A A A A A A A A A A A A A A A A A A J J B B B B B B B B B B B B B A A A A A A A A A A A A A A A A A A A A A A A B B B B B B B B B B J J A A A A B B B B A A A A A A
A A A A A A A A A A A A A A A A A A A A A A A A A A J J B B B B B B B B B B B B A A A A A A A A A A A A A A A A A A A A A A A A A B B B B B B B B B J J J A A B B B B B B B A A A A
A A A A A A A A A A A A A A A A A A A A A A A A A A J J B B B B B B B B B B B A A A A A A A A A A A A A A A A A A A A A A A A A A A B B B B B B B B J J J J J J J B B B B B B A A A
A A A A A A A A A A A A A A A A A A A A A A A A A A J J B B B B B B B B B B A A A A A A A A A A A A A A A A A A A A A A A A A A A A A A B B B B B B J J J J J J J B B B B B B A A A
A A A A A A A A A A A A A A A A A A A A A A A A A A J J B B B B B B B B A A A A A A A A A A A A A A A A A A A A A A A A A A A A A A A A A A A B B B J J J A A B B B B B B B B A A A
A A A A A A A A A A A A A A A A A A A A K K K K K K J J K K K K K K K K K A A A A A A A A A A A A A A A A A A A A A A A A A A A A A A A A A A A A A J J A A A B B B B B B B B A A A
A A A A A A A A A A A A A A A A A A K K K L L L K L J J L L L L L L L L K A A A A A A A A A A A A A A A A A A A A A A A A A A A A A A A A A A A A A J J A A A A A B B B B B A A A A
A A A A A A A A A A A A A A A A A A K L L L L L K L J J L L L L L L L L K A A A A A A A A A D D D D D D D D D D D A A A A A A A A A A A A A A A A A J J A A A A A A A A A A A A A A
A A A A A A A A A A A A A A A A A A K L M L L L L L J J L L L L L L L L L K A A A A A A A D D D D D D D D D D D D D A A A A A A A A A A A A A A A A J J A A A A A A A A A A A A A A
A A A A A A A A A A A A A A A A A A K L L L L L K L L L L L L L L L L L L K A A A A A A D D D D D D D D D D D D D D D A A A A A A A A A A A A A A A J J A A A A A A A A A A A A A A
A A A A A A A A A A A A A A A A A A K L L L L L K L L L L L L L L L L L L K A A A A A A D D D D D D D D D D D D D D D D A A A A A A A A A A A A A A J J K K K K K K K K K K A A A A
A A A A A A A A A A A A A A A A A A K L L L L L K L L L L L L L L L L L L K A A A A A D D D D D D D D D D D D D D D D D D A A A A A K K K K K K K K J J L L L L L K L L L K A A A A
A A A A A A A A A A A A A A A A A A K K K K K K K L L L L L L L L L L L L K A A A A A D D D D D D D D A A A A D D D D D D A A A A A K L L L L L L L J J L L L L L K L L L K A A A A
A A A A A A A A A A A A A A A A A A K L L L L L L L L L L L L L L L L L L K A A A A A D D D D D D D D A A I A D D D D D D D A A A A K K L L L L L L J J L L L L L K L L L L K A A A
A A A A A A A A A A A A A A A A A A K L L L L L L L L L K K K K K K L L K K A A A A A F F F F F F F F A A A A D D D D D D D A A A A A K L L L L L L J J L L L L L K L L L L K A A A
A A A A A A A A A A A A A A A A A A K L L L L L L L L L K L L L L L L L L K A A A A A F D D D D D D D A A A A D D D D D D D A A A A A K L L L L L L J J L L L L L K L L L L K A A A
A A A A A A A A A A A A A A A A A A K L L L L L L L L L K L L L L L L L L K A A A A A A D D D D D D D D D D D D D D D D D D A A A A A K L L L L L L J J L L L L L K L L L L K A A A
A A A A A A A A A A A A A A A A A A K L L L L L L L L L K L L L L L L L L K A A A A A A D D D D D D D D D D D D D D D D D D A A A A A K K L L L L L L L L L L L L K K L L L K A A A
A A A A A A A A A A A A A A A A A A K L L L L L L L L L K L L L L L M L L K A A A A A A A D D D D D D D D D D D D D D D D D A A A A A A K L L L L L L L L L L L L L L L L L K A A A
A A A A A A A A A A A A A A A A A A K L L L L L L L L L K K L L L L L L L K A A A A A A A D D D D D D D D D D D D D D D D A A A A A A A K K K K K K K K K K K K L L L L L L K A A A
A A A A A A A A A A A A A A A A A A K K K K K L L L L L L K L L L L L L L K A A A A A A A A D D D D D D D D D D D D D D D A A A A A A A K L L L L L L L L L L K K K K L L L K A A A
A A A A A A A A A A A A A A A A A A A A A A K K K K K K K K K L L L L L L K A A A A A A A A A A D D D D D D D D D D D D A A A A A A A A K L L L L L L L L L L L L L L L L L K A A A
A A A A A A A A A A A A A A A A A A A A A A A A A A A A A A A K K K K K K K A A A A A A A A A A A A D D D D D D D D D A A A A A A A A A K L L L L L M L L L L L L L L L L L K A A A
A A A A A A A A A A A A A A A A A A A A A A A A A A A A A A A A A A A A A A A A A A A A A A A A A A A A A A A A A A A A A A A A A A A A K L L L L L L L L L L L L L L L L L K A A A
A A A A A A A A A A A A A A A A A A A A A A A A A A A A A A A A A A A A A A A A A A A A A A A A A A A A A A A A A A A A A A A A A A A A K K L L L L L L L L L L L L L L L L K A A A
A A A A A A A A A A A A A A A A A A A A A A A A A A A A A A A A A A A A A A A A A A A A A A A A A A A A A A A A A A A A A A A A A A A A A K K K K K K K K K K K K K K K K K K A A A
A A A A A A A A A A A A A A A A A A A A A A A A A A A A A A A A A A A A A A A A A A A A A A A A A A A A A A A A A A A A A A A A A A A A A A A A A A A A A A A A A A A A A A A A A A
A A A A A A A A A A A A A A A A A A A A A A A A A A A A A A A A A A A A A A A A A A A A A A A A A A A A A A A A A A A A A A A A A A A A A A A A A A A A A A A A A A A A A A A A A A
A A A A A A A A A A A A A A A A A A A A A A A A A A A A A A A A A A A A A A A A A A A A A A A A A A A A A A A A A A A A A A A A A A A A A A A A A A A A A A A A A A A A A A A A A A
A A A A A A A A A A A A A A A A A A A A A A A A A A A A A A A A A A A A A A A A A A A A A A A A A A A A A A A A A A A A A A A A A A A A A A A A A A A A A A A A A A A A A A A A A A
A A A A A A A A A A A A A A A A A A A A A A A A A A A A A A A A A A A A A A A A A A A A A A A A A A A A A A A A A A A A A A A A A A A A A A A A A A A A A A A A A A A A A A A A A A
